нитазол|аминитразол,трихоцид,
допмин|допамекс,априкал,допамекс,допамин,
адипалит|адипалит,нематоцин,
ципробай|ципринол,цифлозин,ципрофлоксацин,цифран,ципролет,квинтор,
тромбозол|гедулин,гедулин,фениндион,
цефтазидим|цефтазидим,кефадим,мироцеф,
сульфален|келфизин,сульфаметопиразин,
теспамим|теспамим,тиотэф,тиотепа,
этаперазин|перфеназин,хлорпиперазин,фентазин,
немотан|нимотоп,нимотопс,немотан,
амфостат|амфостат,фунгизон,
ульфамид|гастроген,антодин,апо–фамотидин,блокацид,гастроген,авамател,лицедил,ново–фамотидин,пепсидин,фамогард,фамонид,фамосан,фамоцид,
димексид|демасорб,гиадур,
сульфакарбамид|сульфакарбамид,урамид,
антиформ|антифомсилан,
панадол|доламин,алведон,доламин,эффералган,
мебгидролин|диазолин,омерил,
ди–адрессон|ди–адрессон,
цифодизим|цифодизим,
фризиум|клобазам,
ттс “циперкутен”|цититон,цитизин,
левотироксин натрия|l–тироксин,
нафтифин|фетимин,
цефотаксим|цефотаксим,
синтомицина линимент|синтомицина эмульсия,
натрия тиосульфат|натрия гипосульфит,
стазепин|стазепин,финлепсин,карбамазепин,
празиквантель|билтрицид,ценариде,
карвитол|карвитол,метопролол,беталок,спесикор,битартрат метопролола,
бета–ацетилдигоксин|бета–ацетилдигоксин,
симальдрат|гелюсил,
аллерган|дипразин,пипольфен,фенерган,
брикарил|бриканил,арубендол,брицин,тербуталин,
пентоксифиллин|агапурин,агапурин,пентилин,ралофект,флекситал,кинетал,
адекин|адекин,апетиген,ципродин,ципрогептадина гидрохлорид,
депамид|вальпроевая кислота,апилепсин,адедипрол,депакин,ацедипрол,депамид,энкорат,
оргаметрил|линестренол,
ново–фамотидин|гастроген,антодин,апо–фамотидин,блокацид,гастроген,авамател,лицедил,пепсидин,ульфамид,фамогард,фамонид,фамосан,фамоцид,
билипак|билипак,цистобил,холевид,
гуамид|гуамид,сульфагуанид,
панадол|алведон,доламин,панадол,эффералган,
натрия нуклеоспермат|полидан,
ципротерона ацетат|андрокур,ципротерон,
глюдиазинамид|минидиаб,глибенез,глюкотрол,глюдиазинамид,мелизид,менодиаб,миндиаб,минибетик,минодиаб,
ганглефена гидрохлорид|ганглерон,
диазолин|мебгидролин,омерил,
нашатырь|нашатырь,ацидамон,
неозепам|неозепам,эуноктин,радедорм,
фамогард|антодин,апо–фамотидин,блокацид,гастроген,авамател,лицедил,ново–фамотидин,пепсидин,ульфамид,фамогард,фамонид,фамосан,фамоцид,
цефлон|цепорекс,цефлон,орацеф,кефлекс,
триомбраст|верографин,урографин,уротраст,урополинум,тразограф,
апо–дилтиаз|блопальцин,дилтиазем,дилтизем,алдиазем,ангизем,дилзем,апо–дилтиаз,гербессер,
авамател|антодин,апо–фамотидин,блокацид,гастроген,авамател,лицедил,ново–фамотидин,пепсидин,ульфамид,фамогард,фамонид,фамосан,фамоцид,
катанил|катанил,диабинез,
ондансетрон|зофран,
фурадантин|фурадантин,нитрофурантоин,
хлорпромазин|хлорпромазин,мегафен,
кордафен|кардипин,коринфар,адалат,нифедипин,кордафен,кальцигард,нифедикап,
вольтарен|вольтарен,диклофенак–натрий,диклофенак,наклофен,
этопозид|вепезид,эпиподофиллотокс,вепзид,везпид,
ниурон|нибиол,5–нок,нибиол,
антодин|гастроген,апо–фамотидин,блокацид,гастроген,авамател,лицедил,ново–фамотидин,пепсидин,ульфамид,фамогард,фамонид,фамосан,фамоцид,
оксибутинин|оксибутинин,
10|бензоил пероксид,окси 5,
неулактил|неулактил,перициазин,
фламазин|дермазин мазь,
норэтистерон|норэтистерон,ановул,анзолан,гормолютон,
сульфинпиразон|апо–сульфинпиразон,
карвазин|изокет,динитросорбилонг,изокет,изосорбида динитрат,
депо–сульфамид|депо–сульфамид,мадрибон,
гексамидин|лепсирал,сертан,
нашатырный спирт|аммиака раствор,
фамогард|гастроген,антодин,апо–фамотидин,блокацид,гастроген,авамател,лицедил,ново–фамотидин,пепсидин,ульфамид,фамонид,фамосан,фамоцид,
сульфадиметоксин|депо–сульфамид,мадрибон,
лурселл|липомал,липомал,
этиодан|йофендилатум,миодил,йофендилатум,
бензбромарон|бензбромарон,дезурик,нормурат,
прокорум|галлопамил,
декортон|дезоксикортон,докса,декортон,перкортен,
бенемицин|бенемицин,рифадин,римактан,
тиаприд|тиогуанин,
сенорм|галдол,алоперидин,галдол,
тестостерон андеканоат|андриол,
солюглауцит|фосфакол,минтакол,
пентотиобарбитал|тиопентал натрия,пентотиобарбитал,тионан,
фенобарбитал|люминал,барбинал,дормирал,
сустак|нитронг,нитро–мак,сустонит,
акритоин|акритоин,
диамокс|диамокс,фонурит,ацетазоламид,
кефлин|цефалотин,
билетан|тиоктацид,билетан,
катопил|ангиоприл,каптоприл,ангиоприл,тензиомин,
изохол|билизорин,изохол,никоформ,
менадион натрия бисульфит|викасол,
локсуран (б)|локсуран (б),баноцид,диэтилкарбамазин,
тонофолин|цитворум–фактор,лейковорин,цитворум–фактор,хемифолин,ледерфолин,рескуфолин,
лейковорин|лейковорин,цитворум–фактор,хемифолин,ледерфолин,рескуфолин,тонофолин,
верапамил|изоптин,веранорм,верапамил,лекоптин,
хлористоводородная кислота разведенная|соляная кислота,
оликард|изосорбид мононитрат,
карзил|гепадестал,силимарин,карзил,лепротек,
эритромицин|флуразепама гидрохлорид,
ферроцерон|эритростимулин,
фурацилин|хемофуран,фурацин,нитрофуран,
бензонал|бензобарбитал,
таразин|труксал,таразин,ветакалм,
энербол|пуритинол,энербол,энцефабол,
таривид|офлоксацин,заноцин,
хенодезоксихолевая кислота|хенодезоксихолевая кислота,хенохол,
празиквантель|празиквантель,ценариде,
теобиолонг|дурофиллин,ксантивент,ретафил,теобиолонг,теотард,теоцин,
цифлозин|цифлозин,ципрофлоксацин,цифран,ципробай,ципролет,квинтор,
бензатин–пенициллин|дуапен,дуапен,бензатина бензилпенициллин,
лодерикс|сетастин,
гемофер пролонгатум|гемофер пролонгатум,сульфат железа,феоспан,
фосфэстрол|цитонал,фосфостильбен,хонван,
авлосульфон|авлосульфон,дапсон,
тиотепа|теспамим,тиотэф,теспамим,
апурин|аллопуринол,милурит,
гигротон|гигротон,хлорталидон,урандил,
ацигност|гастродиагност,гастродиагност,пептавлон,
дуфадин|диаметон,диаметон,
карбенициллин|геопен,пиопен,геопен,
авамател|гастроген,антодин,апо–фамотидин,блокацид,гастроген,лицедил,ново–фамотидин,пепсидин,ульфамид,фамогард,фамонид,фамосан,фамоцид,
липомал|липомал,лурселл,
паркопан|циклодол,артан,ромпаркин,тригексифенидил,
обрацин|бруламицин,небцин,тобрамицин,брулацин,
гастроген|антодин,апо–фамотидин,блокацид,гастроген,авамател,лицедил,ново–фамотидин,пепсидин,ульфамид,фамогард,фамонид,фамосан,фамоцид,
мезокарб|сиднокарб,
геласпон|желатин,гельфоум,
тиберал|орнидазол,
лошадиный иммуноглобулин|атгам,
но–спазм|прифиния бромид,
тримоксазол|бисептол,берлоцид,септрин,сульфаметаксозол,тримоксазол,ко-тримоксазол,
мио–релаксин|дитилин,листенон,
антитанил|дигидротахистерол,тахистин,ат—10,
контраспазмин|контраспазмин,спиропент,
эуноктин|неозепам,эуноктин,радедорм,
утициллин|карфециллин натриевая соль,
зидовудин|интерферон,ретровир,азидотимидин,
хинаголида гидрохлорид|хинаголида гидрохлорид,
дибазин|дибазин,фентоламин,
бромокрептин|бромокрептин,бромэргон,правидель,
гексобарбитал|гексобарбитал,эвипан натрий,гексабарбитала натрий,нарконал,
апилепсин|вальпроевая кислота,апилепсин,адедипрол,депакин,ацедипрол,депамид,энкорат,
компламин|теоникол,компламин,ксавин,
проспидин|просподия хлорид,
нормосекретол|атровент,норсекрол,ипратропия бромид,
трихоцид|аминитразол,аминитразол,
буформин|глибутид,адебит,силубин,
кемовиран|кемовиран,вирузона,
кальцигард|адалат,кардипин,коринфар,адалат,нифедипин,кордафен,нифедикап,
гидромедин|гидромедин,
фарматекс|бензалкония хлорид,
тубазид|тубазид,андразид,искотин,
апилепсин|депакин,вальпроевая кислота,адедипрол,депакин,ацедипрол,депамид,энкорат,
октадин|изобарин,исмелин,
кетоконазол|кетоконазол,низорал,фунгорал,
синкумар|аценокоумарол,тромбостоп,
индометацин|индоцид,метиндол,
тиорил|меллерил,тиорил,
лопресор|карвитол,метопролол,беталок,спесикор,битартрат метопролола,
кристациллин|биоциллин,кристациллин,новоциллин,прокаин–пенициллин,
гуанфацин|гуанфацин,гуанфацина гидрохлорид,
эвипан натрий|гексабарбитала натрий,гексобарбитал,гексабарбитала натрий,нарконал,
андрокур|ципротерон,ципротерона ацетат,
кетанов|торадол,нато,кеторол,торадол,торолак,
изупрел|изадрин,алудрин,новодрин,эуспиран,
флуфеназин|лиродин–депо,флуфеназин,
лоразепам|апо–лоразепам,
хлорпротиксен|труксал,таразин,ветакалм,
кинекс|депосульфал,спофадазин,алтезол,депосульфал,ледеркин,
изосорбида динитрат|изокет,карвазин,динитросорбилонг,изокет,
трибенозид|гливенол,
лозартан калия|лозартан калия,
ламидон|ибупрофен,бруфен,
правидель|бромокрептин,бромокрептин,бромэргон,
этофенамат|этофенамат,роймон,
тиглид|тагрен,тагрен,
цефтазидим|цефтазидим,кефадим,мироцеф,
церукал|метоклопрамид,реглан,перинорм,
силибинин|легалон,
аммиака раствор|нашатырный спирт,
ацикловир*|валацикловир,
стиптицин|оксистептин,оксистептин,стиптоген,
аденил|аденил,
бенадрил|димедрол,аллерган б,
дезоксикортикостерона ацетат|дезоксикортон,докса,декортон,перкортен,
норсекрол|атровент,нормосекретол,ипратропия бромид,
ацеколин|ацеколин,цитохолин,
дифадал|вагоспазмил,вагоспазмил,
бенемицин|бенемицин,рифадин,римактан,
андрофорт|андрофорт,тестолютин,
эринит|нитропентон,пентрит,дилкоран–80,
новодрин|алудрин,изупрел,новодрин,эуспиран,
кетанест|кетамин,кетанест,кеталар,кетаект,калипсол,
пенброк|ампициллина натриевая соль,пентрексил,
нато|торадол,кетанов,кеторол,торадол,торолак,
пробукол|липомал,лурселл,
артеренол|артеренол,норексадрин,норэпинефрин,
тримоксазол|бактрим (суспензия),бисептол,берлоцид,септрин,сульфаметаксозол,ко-тримоксазол,
витамин рр|витамин рр,
премарин|гормоплекс,гормоплекс,эстрофеминал,
веронал|веронал,этибарбитал,барбитурал,
келфизин|келфизин,сульфаметопиразин,
тетрагидрозолина гидрохлорид|тетризолин,тетрагидрозолина гидрохлорид,
эпиподофиллотокс|вепезид,эпиподофиллотокс,вепзид,везпид,
кальция фолинат|лейковорин,цитворум–фактор,хемифолин,ледерфолин,рескуфолин,тонофолин,
гиповаз|адверзутен,фурарозина гидрохлорид,гиповаз,минипресс,пратсиол,синетенз,
секатоксин|дигидроэрготоксин,дигидроэрготоксин,эрготоксин д.г,
интраконазол|интраконазол,
дилтиазем|дилзем,блопальцин,дилтизем,алдиазем,ангизем,дилзем,апо–дилтиаз,гербессер,
гедулин|гедулин,тромбозол,фениндион,
урбазон|урбазон,медезон,метилпреднизолон,солю–медрол,
перметрин|перметрин,
ганглерон|ганглефена гидрохлорид,
оксазепам|тазепам,оксазепам,
платифиллин|платифиллин,
пентазоцин|пентазоцин,
амоксициллин|амоксициллин,
прогестерон|прогестин,прогелан,
вермокс|мебедазол,немазол,антиокс,медозил,
трексил|терфенадин,
кеталар|калипсол,кетамин,кетанест,кетаект,калипсол,
бронхопрон|амбробен,бронхопрон,дигноброксол,мукосолван,амброксол,
этионизин|этионизин,иридозин,
бимарал|бромоприд,
феоспан|гемофер пролонгатум,сульфат железа,гемофер пролонгатум,
донормил|доксиламин,
пирензепин|пирензепин,гастрил,гастрозем,гастрозепин,
карбенициллина динатриевая соль|пиопен,геопен,карбенициллин,
виролекс|валацикловир,
фенигидин|кардипин,коринфар,адалат,нифедипин,кордафен,кальцигард,нифедикап,
меллерил|тиорил,тиорил,
желатин|желатин,гельфоум,
орабетик|букарбан,карбутамид,надизан,оранил,
ортофен|вольтарен,диклофенак–натрий,диклофенак,наклофен,
люминал|люминал,барбинал,дормирал,
теотард|дурофиллин,ксантивент,ретафил,теобиолонг,теотард,теоцин,
пиридостигмин|пиридостигмин,местинон,пиридостигмина бромид,
диолан|дионин,диолан,
вагоспазмил|дифадал,вагоспазмил,
бутадион|фенилбутазон,
изониазид|тубазид,андразид,искотин,
норсульфазол|цибазол,сульфазол,
гемцитабин|гемзар,
атрикан 250|тенонитрозол,
эффортил|этиладрионол,этиладрионол,
алкеран|алкеран,мелфалан,саркоклорин,
сальбутамол|вентолин,
ксилометазолин|галазолин,отривин,
пипольфен|дипразин,аллерган,фенерган,
бефорал|бефорал,морадол,стадол,
партусистен|партусистен,фенотерол гидробромид,фенотерол,
атаракс|гидроксизин,
ятрен|ятрен,абитрен,авлохин,
дексазон|гаммакортен,дексазон,
триперидол|трифлуперидол,триперидол,
нитро–мак|нитронг,сустак,сустонит,
адиазин|адиазин,сульфадиазин,сульфапиримидин,
соляная кислота|хлористоводородная кислота разведенная,
верографин|верографин,урографин,уротраст,урополинум,тразограф,
хемофуран|хемофуран,фурацин,нитрофуран,
берлоцид|бактрим (суспензия),бисептол,септрин,сульфаметаксозол,тримоксазол,ко-тримоксазол,
соласпон|соласпон,новотрон,сульфоназин,
туринал|гестанин,оргагестон,аллилэстренол,
аденокор|аденозин фосфат,
оксибрал|винкамин,
ятрен|абитрен,абитрен,авлохин,
бенактизин|актозин,бенактизин,луцидил,
криптонол|хинозол,оксиквинол,
глибенез|минидиаб,глибенез,глюкотрол,глюдиазинамид,мелизид,менодиаб,миндиаб,минибетик,минодиаб,
пентобарбитал|нембутал натрия,пентобарбитал,натрикум,
хлорамфеникол|биофеникол,биофеникол,
сульфасалазин|салазопирин,салазосульфопиридин,
нимотоп|нимотоп,нимотопс,немотан,
дипироксим|тримедоксин,
липоевая кислота|тиоктацид,билетан,
оксациллин|криптоциллин,оксациллин,резистопен,
фенерган|дипразин,пипольфен,аллерган,
фосфоцин|фосфомицин,
прозерин|неостигмина метилсульфат,простигмина метилсульфат,
доламин|алведон,доламин,панадол,эффералган,
сангостатин|адреноксил,адреноксил,хромадрен,
гидрохлоротиазид|гидрохлоротиазид,дигидрохлортиазид,дихлотиазид,эзидрекс,нефрикс,
ципролет|ципринол,цифлозин,ципрофлоксацин,цифран,ципробай,квинтор,
сайзен|тибон растворимый,
добутамин|добутамин,добуэсект,
артамин|артамин,d–пеницилламин,троловол,
адиазин|адиазин,сульфадиазин,сульфапиримидин,
хингамин|хингамин,хлорохин,резохин,
нитро–мак|сустак,нитро–мак,сустонит,
альфацет|цефаклор,альфацет,
эргокальциферол|витамин d2,кальциферол,
ациметион|ациметион,тиомедон,
слоу–тразиктор|оксапренолол гидрохлорид,оксапренолол гидрохлорид,
тизин|тетризолин,тетрагидрозолина гидрохлорид,
эуфиллин|аминофиллин,диафиллин,тефамин,
винкопан|винкамин,
сульфагуанид|гуамид,гуамид,
паск–натрий|аминацил,аминацил,пропаза,
дитилин|мио–релаксин,листенон,
сотагексал|дароб,дароб,соталекс,
нимодипин|нимотоп,нимотопс,немотан,
цитворум–фактор|лейковорин,цитворум–фактор,хемифолин,ледерфолин,рескуфолин,тонофолин,
терфенадин|терфенадин,
натрия фторид|кореберон,натрия флюорат,
польфамицин|амбрамицин,амбрамицин,
празозин|адверзутен,фурарозина гидрохлорид,гиповаз,минипресс,пратсиол,синетенз,
добесифар|добезилат кальция,добесифар,доксилек,
депо–провера|депо–провера,медроксипрогестерон,фарлутал,провера,
дипидолор|пиритрамид,
дипотассиум клоразепат|дикалия клоразепат,дикалия клоразепат,
уротропин|гексаметилентетрамин,гексамина,урисол,
циклофосфамид|эндоксан,циклофосфамид,
диазинамид|эпразин,диазинамид,пиразинамид,кевезид,
гемитон|гемитон,катапресан,клонидин,хлофазолин,
нематоцин|адипалит,адипалит,
карзил|гепадестал,гепадестал,силимарин,лепротек,
норпролак|хинаголида гидрохлорид,
панкаин|аминокаин,прокаина гидрохлорид,аминокаин,цитокаин,синтокаин,
норколут|норэтистерон,ановул,анзолан,гормолютон,
цитонал|цитонал,фосфостильбен,хонван,
регитин|дибазин,фентоламин,
глаукостат|глаукостат,
алзолам|алпразолам,
тенонитрозол|атрикан 250,
биогризин|биогризин,грицин,
силубин|адебит,силубин,буформин,
спесикор|карвитол,метопролол,беталок,спесикор,битартрат метопролола,
натрия флюорат|натрия фторид,кореберон,
медигоксин|ланитоп,метилдигоксин,ланитоп,
блеомицин|блеоцин,блеомицин,
карбокромен|интенсаин,интенкордин,
фазижин|фазижин,триканикс,тинигин,тиниба,
сульфадимеразин|сульфадимезин,
карнитина хлорид|долотин,новаин,
альмефрол|витамин е,эгевит,альмефрол,эвитан,
прегнорал|этистерон,прогесторал,этистерон,
нордитропин|соматотропин,
атгам|лошадиный иммуноглобулин,
аглюмин|дицинон,дицин,циклонамин,
натрия пара–аминосалицилат|паск–натрий,аминацил,пропаза,
леводопа|допафлекс,l–допа,допафлекс,
бетанозе|даонил,глибенкламид,даонил,гилемал,глинил,глиформин,
правастатин|правастатин,
редактив|нормикс,редактив,
пепсидин|гастроген,антодин,апо–фамотидин,блокацид,гастроген,авамател,лицедил,ново–фамотидин,ульфамид,фамогард,фамонид,фамосан,фамоцид,
платинол|платидиам,платинол,платин,
фурацин|хемофуран,фурацин,нитрофуран,
флокорт|флокорт,синандон,флюоцинолона ацетонид,синалар,флюцинар,
зантак|зантак,ацилок–е,гистак,зоран,ранисан,улькуран,
митотан|хлодитан,
хлорхинальдол|квезил,
догматил|догматил,сульпирид,сульпирил,
протионамид|тревентикс,
прогестеро–ретард|оксипрогестерона капронат,примолют–депо,
кеталар|кетамин,кетанест,кеталар,кетаект,калипсол,
колимицин|неомин,неомин,
пренолон|дакортин,дакортин,метакорталон,низолон,
эрготоксин д.г|дигидроэрготоксин,дигидроэрготоксин,секатоксин,
оксациллина натриевая соль|криптоциллин,оксациллин,резистопен,
барбексаклон|барбексаклон,
паск–натрий|паск–натрий,аминацил,пропаза,
синалар|флокорт,синандон,флокорт,флюоцинолона ацетонид,флюцинар,
дипразин|пипольфен,аллерган,фенерган,
нифедипин|кардипин,коринфар,адалат,нифедипин,кордафен,кальцигард,нифедикап,
финастерид|финастерид,
прокаин–пенициллин|бензилпенициллина новокаиновая соль,биоциллин,кристациллин,новоциллин,
трихофурин|фуразолидон,нифулидон,
ладиомил|ладиомил,мапротилин,
ромпаркин|циклодол,артан,ромпаркин,тригексифенидил,
фамотидин|антодин,
тизерцин|метотримепразин,нозинан,левомепромазин,
фамосан|гастроген,антодин,апо–фамотидин,блокацид,гастроген,авамател,лицедил,ново–фамотидин,пепсидин,ульфамид,фамогард,фамонид,фамоцид,
батрафен|циклопирокс,
дактарин|дактарин,миконал,суролан,
лицедил|гастроген,антодин,апо–фамотидин,блокацид,гастроген,авамател,ново–фамотидин,пепсидин,ульфамид,фамогард,фамонид,фамосан,фамоцид,
дибазин|дибазин,фентоламин,
сонапакс|меллерил,тиорил,
оксатомид|оксатомид,
тамоксифен|зитазониум,нольвадекс,
гистак|зантак,ранитидин,ранитидин гидрохлорид,зоран,ранисан,ранитин,
ретафил|дурофиллин,ксантивент,ретафил,теобиолонг,теотард,теоцин,
мадрибон|депо–сульфамид,депо–сульфамид,
дезурик|дезурик,
дианабол|дианабол,неробол,
диакарб|диамокс,фонурит,ацетазоламид,
сульпирид|сульпирид,догматил,сульпирил,
соталекс|дароб,дароб,сотагексал,
диклофенак|вольтарен,диклофенак–натрий,диклофенак,наклофен,
глибенкламид|даонил,даонил,бетанозе,гилемал,глинил,глиформин,
триамцинолон|кенакорт,ледеркорт,триамцинолон,берликорт,
тазепам|оксазепам,оксазепам,
тримеперидин|тримеперидин,
трихлорен|трилен,трилен,наркоген,
цефалин|цефалин,тиопропиразин,
гигроний|трепирий йодид,
биофеникол|биофеникол,хлорамфеникол,
миндиаб|глибенез,минидиаб,глибенез,глюкотрол,глюдиазинамид,мелизид,менодиаб,минибетик,минодиаб,
апресолин|апресолин,гидралазин,
нео–гилуритмал|праймалия битартрат,
гаммакортен|дексазон,дексазон,
альфакальцидол|альфа д3–тева,
пентобарбитал|этаминал–натрий,нембутал натрия,натрикум,
теоцин|дурофиллин,дурофиллин,ксантивент,ретафил,теобиолонг,теотард,
протактил|промилен,промилен,
акрицид|акрицид,риванол,
ципробай|цифлозин,ципрофлоксацин,цифран,ципробай,ципролет,квинтор,
бензатин–пенициллин|бензатин–пенициллин,дуапен,бензатина бензилпенициллин,
цитозар|цитозар,алексан,
тримедоксин|дипироксим,
никотинамид|аминикотин,никофорт,
нитронг|сустак,нитро–мак,сустонит,
циклопентиазид|циклопентиазид,навидрекс,
зитазониум|тамоксифен,нольвадекс,
омезол|зероцид,лосек,омез,омезол,омзол,омепрол,омизак,ортанол,осид,промезол,
фарестон|торемифен,
никоформ|изохол,билизорин,изохол,
тантум|бензидамин,
келфизин|келфизин,сульфаметопиразин,
диаметон|диаметон,дуфадин,
адельфан—эзидрекс|тринитон,трирезид,
амикин|биклин,биклин,бриклин,
домонид|версед,флормидал,дормонид,версед,
стазепин|тегретол,финлепсин,карбамазепин,
медоклацид|диамикрон,гликлазид,диамикрон,
рескуфолин|лейковорин,цитворум–фактор,хемифолин,ледерфолин,рескуфолин,тонофолин,
тинигин|фазижин,фазижин,триканикс,тиниба,
горькая соль|горькая соль,магнезия сернокислая,
аневрин|витамин в1,витамин в1,
бисольвон|бисольвон,паксиразол,
лосек|зероцид,зероцид,омез,омезол,омзол,омепрол,омизак,ортанол,осид,промезол,
називин|оксиметазолин,
эпиподофиллотокс|везпид,вепезид,вепзид,везпид,
низолон|дакортин,метакорталон,низолон,пренолон,
депостат|примостат,
алкеран|алкеран,мелфалан,саркоклорин,
тахистин|дигидротахистерол,антитанил,ат—10,
дормонид|версед,флормидал,домонид,версед,
урбазон|медезон,урбазон,метилпреднизолон,солю–медрол,
хемифолин|лейковорин,цитворум–фактор,хемифолин,ледерфолин,рескуфолин,тонофолин,
андаксин|андаксин,седанил,мепротан,
пропранолол|индерал,индерал,обзидан,
силимарин|гепадестал,силимарин,карзил,лепротек,
местинон|пиридостигмин,пиридостигмин,пиридостигмина бромид,
сульфакарбамид|урамид,урамид,
хлоразепам|транекс,хлоразепам,
кортелан|адресон,адресон,
спесикор|беталок,карвитол,метопролол,беталок,битартрат метопролола,
дигидростибострол|дигидростибострол,новострол,
бензоклидина гидрохлорид|бензоклидина гидрохлорид,
гибитрон|гибитрон,флуцином,флюцином,цебатрол,дрогенил,эуфлекс,фугерол,фульфорель,нифтолид,норекс,
сульфатиазол|сульфатиазол,серебрянная соль сульфатиазола,
хифенадин|квифенадин,хифенадин,
рибофлавин|витамин в2,лактофлавин,
азамид|азамид,пикнолепсин,этосуксимид,
азамид|азамид,пикнолепсин,этосуксимид,
сульфацил–натрий|альбуцид–натрий,пронтамид,сульфацетамид,
иридозин|этионизин,иридозин,
аскаридил|аскаридил,кетракс,
дионин|дионин,диолан,
саркоклорин|алкеран,алкеран,мелфалан,
витамин а|витамин а,аксерофтол,
сульфаталидин|фталилсульфатиазол,сульфаталидин,талазол,
тиоридазин|апо–тиоридазин,
немазол|мебедазол,немазол,антиокс,медозил,
глибенез|глибенез,минидиаб,глюкотрол,глюдиазинамид,мелизид,менодиаб,миндиаб,минибетик,минодиаб,
ортоклон|ортоклон,окт–3,
хальцион|триазолам,
предиан|гликлазид,диамикрон,медоклацид,
астинивит|витамин с,
эреоквин|эреоквин,гидроксихлорохин,
витамин в2|витамин в2,лактофлавин,
пропанидид|эпонтол,эпонтол,
нибиол|нибиол,5–нок,ниурон,
адебит|адебит,силубин,буформин,
пиразинамид|эпразин,диазинамид,пиразинамид,кевезид,
метрогил|эфлоран,флагил,метронидазол,клион,клион–д,эфлоран,
дигидрохлортиазид|гидрохлоротиазид,дигидрохлортиазид,дихлотиазид,эзидрекс,нефрикс,
бусульфан|бусульфан,милеран,
флутиказон|фликсоназе,
левомицетина стеарат|эулевомицетин,
докузат натрия|докузат натрия,
гигротон|гигротон,хлорталидон,урандил,
альдецин|бекломет,бекотид,беклометазон,
пиридостигмина бромид|пиридостигмин,местинон,пиридостигмин,
нарконал|гексабарбитала натрий,гексобарбитал,эвипан натрий,гексабарбитала натрий,
стиптоген|оксистептин,стиптицин,оксистептин,
витамин d2|витамин d2,кальциферол,
гистидина гидрохлорид|ларистин,стеллидин,
гиадур|демасорб,демасорб,
ороназол|кетоконазол,низорал,фунгорал,
ацетеин|ацетеин,флюймуцил,мукомист,мукосольвин,
промилен|промилен,протактил,
гевилон|гемфиброзил,
флонидан|лоратадин,
хиноцид|квиноцид,
ангинин|ангинин,соспитан,продектин,
нифтолид|гибитрон,флуцином,флюцином,цебатрол,дрогенил,эуфлекс,фугерол,фульфорель,гибитрон,норекс,
сульгин|гуамид,сульфагуанид,
гексабарбитала натрий|гексабарбитала натрий,гексобарбитал,эвипан натрий,нарконал,
дуапен|дуапен,бензатин–пенициллин,бензатина бензилпенициллин,
нифедипин|адалат,кардипин,коринфар,адалат,кордафен,кальцигард,нифедикап,
тинидазол|фазижин,триканикс,тинигин,тиниба,
новантрон|митоксантрон,
ацигност|ацигност,гастродиагност,пептавлон,
аметоптерин|метоптерин,аметоптерин,
лазикс|лазикс,фурантрил,
батиловый спирт|батиловый спирт,
терфлюзин|терфлюзин,стелазин,трифлуоперазин,
преднизолон|дакортин,метакорталон,низолон,пренолон,
блопальцин|блопальцин,дилтиазем,дилтизем,алдиазем,ангизем,дилзем,апо–дилтиаз,гербессер,
нормикс|редактив,редактив,
этионамид|этионизин,иридозин,
норадреналина гидротартрат|артеренол,норексадрин,норэпинефрин,
тибон|амитиозон,амитиозон,
докса|дезоксикортон,докса,декортон,перкортен,
триттико|азона,тразодона гидрохлорид,тразодон,
хлороцид с|хлороцид с,
трифлуоперазин|терфлюзин,стелазин,терфлюзин,
хлорамбуцил|хлорамбуцил,леукеран,
терален|алимемазин,алимезин,
альдомет|альдомет,метилдопа,
метирон|тиамазол,метимазол,тимидазол,метизол,тиамазол,
уротраст|верографин,верографин,урографин,урополинум,тразограф,
долотин|долотин,новаин,
конвулекс|вальпроевая кислота,апилепсин,адедипрол,депакин,ацедипрол,депамид,энкорат,
пелентан|дикумарин,
циметидин|гистодил,тагамет,нейтронорм,беломет,
депсонил|имипрамин,имизин,тофранил,имипрамин,
синтокаин|аминокаин,прокаина гидрохлорид,аминокаин,цитокаин,панкаин,
пентрексил|ампициллина натриевая соль,пенброк,
эулевомицетин|эулевомицетин,
бромокрептин|бромокрептин,бромэргон,правидель,
аминазин|хлорпромазин,мегафен,
изобарин|исмелин,октадин,
кетамина гидрохлорид|кетамин,кетанест,кеталар,кетаект,калипсол,
пиперазина адипинат|адипалит,нематоцин,
адресон|адресон,кортелан,
теоникол|теоникол,компламин,ксавин,
зероцид|зероцид,лосек,омез,омезол,омзол,омепрол,омизак,ортанол,осид,промезол,
сульфаэтидол|этазол,
амфостат|амфостат,фунгизон,
йопагност|билипак,цистобил,холевид,
низолон|дакортин,дакортин,метакорталон,пренолон,
тетразепам|тетразепам,
омзол|зероцид,зероцид,лосек,омез,омезол,омепрол,омизак,ортанол,осид,промезол,
проскар|финастерид,
клофелин|гемитон,катапресан,клонидин,хлофазолин,
дилзем|дилзем,блопальцин,дилтиазем,дилтизем,алдиазем,ангизем,апо–дилтиаз,гербессер,
редергин|дигидроэрготоксин,секатоксин,эрготоксин д.г,
азаметония бромид|азаметония бромид,
фенилэфрин|изофрин,адрианол,изофрин,
фетимин|нафтифин,
бромоприд|бимарал,
амбазон|амбазон,
тразодон|азона,тразодона гидрохлорид,триттико,
дормирал|люминал,барбинал,дормирал,
новокаин|прокаина гидрохлорид,аминокаин,цитокаин,панкаин,синтокаин,
метопролол|беталок,карвитол,беталок,спесикор,битартрат метопролола,
ларистин|ларистин,стеллидин,
биогризин|гризеофульвин,грицин,
дезоксикортон|дезоксикортикостерона ацетат,докса,декортон,перкортен,
алудрин|алудрин,изупрел,новодрин,эуспиран,
диабетол|диабетол,орабет,толбутамид,
дактарин|дактарин,миконал,суролан,
дротаверин|дротаверин,
фенилбутазон|бутадион,
аллерган б|аллерган б,бенадрил,
метоклопрамид|церукал,реглан,перинорм,
дурофиллин|дурофиллин,ксантивент,ретафил,теобиолонг,теотард,теоцин,
доламин|доламин,алведон,панадол,эффералган,
алудрин|изадрин,изупрел,новодрин,эуспиран,
авлосульфон|дапсон,дапсон,
сульфатиазол|аргосульфан,серебрянная соль сульфатиазола,
милеран|бусульфан,бусульфан,
эглонил|сульпирид,догматил,сульпирил,
хромогликат натрия|хромогликат натрия,
хлортрионизоэстрол|хлортрианизен,трианизоэстрол,
отривин|отривин,ксилометазолин,
цефлон|цепорекс,цепорекс,орацеф,кефлекс,
тиогуанин|тиаприд,
блопальцин|дилзем,дилтиазем,дилтизем,алдиазем,ангизем,дилзем,апо–дилтиаз,гербессер,
эгевит|витамин е,эгевит,альмефрол,эвитан,
флюороурацил|флюороурацил,
тофранил|имизин,тофранил,депсонил,имипрамин,
азитидин|зидовудин,ретровир,азидотимидин,
барбитурал|веронал,веронал,этибарбитал,
глюкоза|дектроза,декстроза,
ревипарин натрия|ревипарин натрия,
тромбостоп|аценокоумарол,аценокоумарол,
адверзутен|гиповаз,фурарозина гидрохлорид,гиповаз,минипресс,пратсиол,синетенз,
дикалия клоразепат|дипотассиум клоразепат,дикалия клоразепат,
эуноктин|эуноктин,неозепам,радедорм,
тревентикс|тревентикс,
этинилэстрадиол|этинилэстрадиол,фолликорал,
нимотопс|немотан,нимотоп,немотан,
эндоксан|циклофосфамид,циклофосфамид,
аминацил|аминацил,паск–натрий,пропаза,
френолон|метофеназин,
дульколакс|дульколакс,
никофорт|аминикотин,аминикотин,
валиум|диазепам,седуксен,реланиум,диазепам,
гексаметония бензоат|гексаметония бензоат,
седанил|андаксин,андаксин,мепротан,
гемитон|гемитон,катапресан,клонидин,хлофазолин,
диазепам|седуксен,реланиум,валиум,диазепам,
синформон|диовициклин,диовициклин,
бемегрид|этимид,глютамисол,
флуцином|флуцином,флюцином,цебатрол,дрогенил,эуфлекс,фугерол,фульфорель,гибитрон,нифтолид,норекс,
анзолан|гормолютон,норэтистерон,ановул,гормолютон,
гедулин|гедулин,тромбозол,фениндион,
бронхопрон|дигноброксол,амбробен,дигноброксол,мукосолван,амброксол,
нашатырь|аммония хлорид,ацидамон,
фенофибрат|фенофибрат,
кослан|кослан,
небцин|небцин,тобрамицин,брулацин,обрацин,
дерматол|галлат висмута основного,
фарморубицин|эпирубицин,
карвазин|карвазин,динитросорбилонг,изокет,изосорбида динитрат,
диазинамид|диазинамид,эпразин,пиразинамид,кевезид,
актозин|актозин,бенактизин,луцидил,
оксилидин|бензоклидина гидрохлорид,
сульфацетамид|альбуцид–натрий,альбуцид–натрий,пронтамид,
тубазид|изониазид,андразид,искотин,
тагамет|гистодил,циметидин,нейтронорм,беломет,
алькопар|дебефен,дебефен,
тагрен|тагрен,тиглид,
бензбромарон|дезурик,
нифулидон|нифулидон,трихофурин,
эвипан натрий|гексобарбитал,эвипан натрий,гексабарбитала натрий,нарконал,
вирузона|кемовиран,вирузона,
хинаприла гидрохлорид|аккупро,хинаприл,
орабетик|карбутамид,надизан,орабетик,оранил,
комбантрин|пирантель,пирантель памоат,
динитросорбилонг|карвазин,динитросорбилонг,изокет,изосорбида динитрат,
алексан|цитозар,алексан,
стеллидин|гистидина гидрохлорид,ларистин,
оксиметазолин|оксиметазолин,
флюймуцил|ацетеин,ацетеин,мукомист,мукосольвин,
флударабина фосфат|флудара,флударабин,
абитрен|ятрен,абитрен,авлохин,
дицинон|дицин,циклонамин,аглюмин,
весаноид|третиноин,
трилен|трилен,наркоген,трихлорен,
карбамазепин|тегретол,стазепин,финлепсин,
тусупрекс|окселадин цитрат,
синалар|синандон,флокорт,флюоцинолона ацетонид,синалар,флюцинар,
диэтилкарбамазин|дитразина цитрат,локсуран (б),баноцид,
амитиозон|тибон,амитиозон,
обзидан|индерал,обзидан,пропранолол,
эпинефрин|адреналина гидрохлорид,
сульфадиазин|адиазин,сульфадиазин,сульфапиримидин,
туринабол–депо|эуболин,эуболин,нандролона деканоат,нероболил,феноболил,
ниморазол|наксоджин,
тримекаин|мезокаин,
адресон|адресон,кортелан,
цефатрексил|цефапирин натрия,
уромитексан|месна,мистаброн,мукофлюид,
эрготоксин|дигидроэрготоксин,секатоксин,эрготоксин д.г,
гексамина|гексаметилентетрамин,урисол,уротропин,
пиридитол|пуритинол,энербол,энцефабол,
соспитан|ангинин,соспитан,продектин,
параболин|амфепрамон,амфепрамон,
бромурал|бромурал,изобромил,
витамин вс|фолацин,витамин вс,
оксафенамид|дриол,
хлозепид|тимазин,элениум,либриум,
оргагестон|гестанин,гестанин,аллилэстренол,
гемфиброзил|гевилон,
ламизил|тербинафин,
кенакорт|берликорт,ледеркорт,триамцинолон,берликорт,
дезоксикортон|дезоксикортон,докса,декортон,перкортен,
диорон|диорон,оропур,
гастрозем|гастрил,пирензепин,гастрил,гастрозепин,
гепадестал|гепадестал,силимарин,карзил,лепротек,
ориметен|аминоглютетимид,мамомит,
имизин|имизин,тофранил,депсонил,имипрамин,
циклодол|артан,артан,ромпаркин,тригексифенидил,
энцефабол|энербол,пуритинол,энербол,
седоксазин|седоксазин,триметозин,
дараприм|дараприм,тиндурин,
доксилек|добезилат кальция,добезилат кальция,добесифар,
викасол|менадион натрия бисульфит,
депосульфал|депосульфал,спофадазин,кинекс,алтезол,ледеркин,
ацеклидин|глаукостат,
кардипин|адалат,коринфар,адалат,нифедипин,кордафен,кальцигард,нифедикап,
цифлозин|ципринол,ципрофлоксацин,цифран,ципробай,ципролет,квинтор,
дилтизем|дилзем,блопальцин,дилтиазем,алдиазем,ангизем,дилзем,апо–дилтиаз,гербессер,
мегафен|аминазин,хлорпромазин,
ледерфолин|цитворум–фактор,лейковорин,цитворум–фактор,хемифолин,рескуфолин,тонофолин,
апресолин|гидралазин,гидралазин,
диамикрон|гликлазид,диамикрон,медоклацид,
гормолютон|норэтистерон,ановул,анзолан,гормолютон,
биклин|амикин,биклин,бриклин,
дигидроэрготоксин|дигидроэрготоксин,секатоксин,эрготоксин д.г,
нероболил|нандролон,феноболил,туринабол,
бензобарбитал|бензобарбитал,
суролан|дактарин,дактарин,миконал,
дигидротахистерол|тахистин,антитанил,ат—10,
апо–флуразепам|флуразепама гидрохлорид,
аминофиллин|аминофиллин,диафиллин,тефамин,
салметерол|азрол,сальметер,серевент,
блеомицетин|блеоцин,блеомицин,
амикин|амикин,биклин,бриклин,
пульмикорт|будезонид,апулеин,турбухалер,
натрикум|этаминал–натрий,нембутал натрия,пентобарбитал,
актозин|бенактизин,бенактизин,луцидил,
барбинал|люминал,барбинал,дормирал,
новалдин|новалдин,сальпирин,метамизол натрия,
сертан|гексамидин,лепсирал,
протандрен|метандиол,протандрен,
ципродин|адекин,адекин,апетиген,ципрогептадина гидрохлорид,
вентолин|вентолин,
пропилйодон|дионозил,пропиликс,
рибоксин|инозие f,инозин,
тетацин–кальций|хелатон,мосатил,
биклин|биклин,амикин,бриклин,
никодин|билизорин,изохол,никоформ,
торолак|торадол,нато,кетанов,кеторол,торадол,
пипольфен|пипольфен,аллерган,фенерган,
оспамокс|амоксициллин,
флокорт|синандон,флокорт,флюоцинолона ацетонид,синалар,флюцинар,
ксантивент|дурофиллин,дурофиллин,ретафил,теобиолонг,теотард,теоцин,
версед|флормидал,дормонид,домонид,версед,
салазопирин|салазопирин,салазосульфопиридин,
валацикловир|зовиракс,
урисол|гексаметилентетрамин,гексамина,уротропин,
беломет|гистодил,циметидин,тагамет,нейтронорм,
хингамин|делагил,хлорохин,резохин,
гельфоум|желатин,желатин,
хлортрионизоэстрол|хлортрионизоэстрол,трианизоэстрол,
триазолам|хальцион,
диорон|диорон,оропур,
тринитрол|ангинине,ангинине,перлинганит,
веранорм|изоптин,веранорм,верапамил,лекоптин,
трианизоэстрол|хлортрианизен,хлортрионизоэстрол,
кеналог|трикорт,полькортолон,трикорт,
хлортрианизен|хлортрионизоэстрол,трианизоэстрол,
гидрохлоротиазид|дигидрохлортиазид,дигидрохлортиазид,дихлотиазид,эзидрекс,нефрикс,
тетурам|антабус,
луридин|билинеурин,билинеурин,
белустин|ломустин,
рескуфолин|цитворум–фактор,лейковорин,цитворум–фактор,хемифолин,ледерфолин,тонофолин,
кордарон|амиодарон,трангорекс,
трифлуперидол|трифлуперидол,триперидол,
сирдалуд|тринидин,тизанидин,
фосфакол|минтакол,солюглауцит,
гидрокортизона ацетат|гидрокортизон,
антифомсилан|антиформ,
пентилин|пентоксифиллин,агапурин,пентилин,ралофект,флекситал,кинетал,
пирилен|пемпидина тозил,
тринитон|адельфан—эзидрекс,трирезид,
этосуксимид|азамид,азамид,пикнолепсин,
кларитин|лоратидин,
ацетазоламид|диакарб,диамокс,фонурит,
этимид|этимид,глютамисол,
ранитидин|зантак,ранитидин гидрохлорид,гистак,зоран,ранисан,ранитин,
нобриум|рудотель,рудотель,медазепам,
фурацин|хемофуран,хемофуран,нитрофуран,
декарис|аскаридил,кетракс,
рифампицин|бенемицин,рифадин,римактан,
эгевит|витамин е,витамин е,альмефрол,эвитан,
теотард|дурофиллин,дурофиллин,ксантивент,ретафил,теобиолонг,теоцин,
праймалия битартрат|нео–гилуритмал,
трихлорэтилен|трилен,наркоген,трихлорен,
сермион|ницерголин,
этибарбитал|веронал,этибарбитал,барбитурал,
диабинез|катанил,диабинез,
ульфамид|антодин,апо–фамотидин,блокацид,гастроген,авамател,лицедил,ново–фамотидин,пепсидин,ульфамид,фамогард,фамонид,фамосан,фамоцид,
фенотерол гидробромид|беротек,партусистен,фенотерол,
медозил|вермокс,мебедазол,немазол,антиокс,
андрофорт|андрофорт,тестолютин,
низорал|кетоконазол,низорал,фунгорал,
клостильбегит|фертомид,кломифен,фертомид,кломид,
триптизол|дамилена малеинат,амитриптилина малеинат,
омизак|зероцид,зероцид,лосек,омез,омезол,омзол,омепрол,ортанол,осид,промезол,
сульфат железа|гемофер пролонгатум,гемофер пролонгатум,феоспан,
заноцин|офлоксацин,заноцин,
оксазил|амбенона хлорид,мизурана хлорид,
гуанфацин|гуанфацин,гуанфацина гидрохлорид,
витамин в2|витамин в2,лактофлавин,
витамин в1|витамин в1,аневрин,
витамин в6|витамин в6,пиривитол,
изоптин|изоптин,веранорм,верапамил,лекоптин,
бускопан|бутилскополамин,
эпонтол|эпонтол,пропанидид,
билинеурин|билинеурин,луридин,
ремантадин|мерадон,
сентонил|фентанил,фентанилцитрат,
новодигал|бета–ацетилдигоксин,
леукерин|леукерин,пуринетол,
тестолютин|андрофорт,андрофорт,
феназон|анальгезин,анальгезин,
мерадон|ремантадин,
пантокаин|дикаин,тетракаина гидрохлорид,рексокаин,
фосфаден|аденил,
азрол|салметерол,сальметер,серевент,
платидиам|цисплатин,платинол,платин,
ацеколин|ацеколин,цитохолин,
этилхлорид|хелен,хелен,
бензамил|бензамил,бензоилбарбамил,
фортум|цефтазидим,кефадим,мироцеф,
пармидин|ангинин,соспитан,продектин,
нольвадекс|зитазониум,тамоксифен,
нуридал|ниазин,ниазин,
абитрен|абитрен,ятрен,авлохин,
трангорекс|амиодарон,амиодарон,
ановул|гормолютон,норэтистерон,анзолан,гормолютон,
клонидин|гемитон,катапресан,клонидин,хлофазолин,
бензатина бензилпенициллин|дуапен,бензатин–пенициллин,дуапен,
актал|алекситол натрий,
алупент|алупент,
эуболин|эуболин,туринабол–депо,нандролона деканоат,нероболил,феноболил,
окт–3|ортоклон,окт–3,
гексетидин|гексетидин,
норгалакс|докузат натрия,
лазикс|лазикс,фурантрил,
тазепам|тазепам,оксазепам,
d–пеницилламин|артамин,артамин,троловол,
витамин с|витамин с,
ларистин|гистидина гидрохлорид,стеллидин,
ретинола ацетат|витамин а,аксерофтол,
трописетрон|навобан,
допан|хлорэтиламиноурацил,
ксантинола никотинат|теоникол,компламин,ксавин,
глютамисол|этимид,глютамисол,
мепротан|андаксин,андаксин,седанил,
калмепам|бромидем,калмепам,лексилиум,лексотан,нормок,
колларгол|серебро коллоидное,
апо–фамотидин|гастроген,антодин,блокацид,гастроген,авамател,лицедил,ново–фамотидин,пепсидин,ульфамид,фамогард,фамонид,фамосан,фамоцид,
эпразин|эпразин,диазинамид,пиразинамид,кевезид,
сиднокарб|мезокарб,
урамид|сульфакарбамид,урамид,
фторокорт|полькортолон,кеналог,трикорт,
хлоридин|дараприм,тиндурин,
изохол|изохол,билизорин,никоформ,
ангизем|дилзем,блопальцин,дилтиазем,дилтизем,алдиазем,дилзем,апо–дилтиаз,гербессер,
силубин|глибутид,адебит,буформин,
орнидазол|орнидазол,
прокардил|амидопрокаин,амидопрокаин,кардиоритмин,прокаинамида гидрохлорид,прокаинамид,
платидиам|платидиам,платинол,платин,
гибитан|гибитан,хлоргексидин,
теобиолонг|дурофиллин,дурофиллин,ксантивент,ретафил,теотард,теоцин,
тибон|тибон,амитиозон,
овестин|эстриол,
метилпреднизолон|урбазон,медезон,урбазон,солю–медрол,
клоназепам|антелепсин,
диметинден|диметинден,
гимекромон|одестон,
нембутал натрия|этаминал–натрий,пентобарбитал,натрикум,
кливарин|ревипарин натрия,
вальпроевая кислота|депакин,апилепсин,адедипрол,депакин,ацедипрол,депамид,энкорат,
пептавлон|гастродиагност,ацигност,гастродиагност,
байпресс|байпресс,нитрепин,
байпресс|байпресс,нитрепин,
сульфадиазин|адиазин,адиазин,сульфапиримидин,
добесифар|добезилат кальция,добезилат кальция,доксилек,
тробицин|спектиномицин,
депсонил|имизин,тофранил,депсонил,имипрамин,
этакридина лактат|акрицид,риванол,
окси 10|окси 5,10,
перти|абактал,пефлоксацин,пефлацин,
гестанин|гестанин,оргагестон,аллилэстренол,
омепрол|зероцид,лосек,омез,омезол,омзол,омепрол,омизак,ортанол,осид,промезол,
бактрим (суспензия)|бисептол,берлоцид,септрин,сульфаметаксозол,тримоксазол,ко-тримоксазол,
сульфаметопиразин|келфизин,келфизин,
бисептол|бактрим (суспензия),берлоцид,септрин,сульфаметаксозол,тримоксазол,ко-тримоксазол,
люминал|дормирал,барбинал,дормирал,
бетанозе|глибенкламид,даонил,бетанозе,гилемал,глинил,глиформин,
иоподат натрия|билоптин,иоподат натрия,орографин–натрий,
наксоджин|ниморазол,
кетамин|кетамин,кетанест,кеталар,кетаект,калипсол,
омепрол|зероцид,зероцид,лосек,омез,омезол,омзол,омизак,ортанол,осид,промезол,
доксиум|добезилат кальция,добесифар,доксилек,
ниазин|нуридал,ниазин,
депамид|депакин,вальпроевая кислота,апилепсин,адедипрол,депакин,ацедипрол,энкорат,
пирокс|роксикам,роксикам,
тимазин|тимазин,элениум,либриум,
квифенадин|квифенадин,хифенадин,
персантин|персантин,дипирдамол,тромбонил,
кальциферол|витамин d2,витамин d2,
фамонид|антодин,апо–фамотидин,блокацид,гастроген,авамател,лицедил,ново–фамотидин,пепсидин,ульфамид,фамогард,фамонид,фамосан,фамоцид,
неулептил|неулактил,перициазин,
желатин|желатин,гельфоум,
хлоракон|бекламид,
контраспазмин|контраспазмин,спиропент,
дофамин|априкал,допмин,допамекс,допамин,
алпразолам|алзолам,
простигмина метилсульфат|неостигмина метилсульфат,неостигмина метилсульфат,
дионозил|дионозил,пропиликс,
карбоцистеин|карбоцистеин,мукосол,
диовициклин|диовициклин,синформон,
кенакорт|кенакорт,ледеркорт,триамцинолон,берликорт,
кевезид|диазинамид,эпразин,диазинамид,пиразинамид,
изосорбида мононитрат|изосорбида мононитрат,
этистерон|прегнорал,прогесторал,этистерон,
салол|фенилсалицилат,
промилен|промилен,протактил,
тразодона гидрохлорид|азона,тразодон,триттико,
новоциллин|бензилпенициллина новокаиновая соль,биоциллин,кристациллин,прокаин–пенициллин,
синэстрол|дигидростибострол,новострол,
гилемал|глибенкламид,даонил,бетанозе,гилемал,глинил,глиформин,
хелатон|хелатон,мосатил,
пиразидол|пирлидол,
гликлазид|диамикрон,диамикрон,медоклацид,
эфедрин|эфедрин,эфетонин,санедрин,
тиотэф|теспамим,теспамим,тиотепа,
адрианол|изофрин,изофрин,фенилэфрин,
кардиоритмин|амидопрокаин,амидопрокаин,прокардил,прокаинамида гидрохлорид,прокаинамид,
панергал|эргометрина малеат,эргометрин,эрготрата малеат,эргостабил,
гормоплекс|гормоплекс,премарин,эстрофеминал,
гестринон|гестринон,
новоциллин|биоциллин,кристациллин,новоциллин,прокаин–пенициллин,
нитроксолин|5–нок,нибиол,ниурон,
соласпон|новотрон,соласпон,сульфоназин,
прогелан|прогестин,прогелан,
пуритинол|энербол,энербол,энцефабол,
ланитоп|метилдигоксин,ланитоп,медигоксин,
гастродиагност|гастродиагност,ацигност,пептавлон,
солю–медрол|урбазон,медезон,урбазон,метилпреднизолон,
хиниофон|ятрен,абитрен,авлохин,
интраглобин|иммуноглобулин (человеческий),иммуноглобулин (человеческий),
иммуноглобулин (человеческий)|иммуноглобулин (человеческий),интраглобин,
hok|перметрин,
цефоперазон|цефобид,
тахистин|тахистин,антитанил,ат—10,
фульфорель|гибитрон,флуцином,флюцином,цебатрол,дрогенил,эуфлекс,фугерол,гибитрон,нифтолид,норекс,
оропур|диорон,диорон,
депо–сульфамид|депо–сульфамид,мадрибон,
натулан|прокарбазин,
тавегил|клемастина фумарат,
гуанфацина гидрохлорид|гуанфацин,гуанфацин,
деприм|деприм,туриневрин,
тионан|тиопентал натрия,пентотиобарбитал,тионан,
кетазон|кетофенилбутазон,кебузоне,
ванизид|ванизид,
пентагастрин|ацигност,гастродиагност,пептавлон,
троловол|артамин,d–пеницилламин,артамин,
амидопрокаин|амидопрокаин,кардиоритмин,прокардил,прокаинамида гидрохлорид,прокаинамид,
ново–фамотидин|антодин,апо–фамотидин,блокацид,гастроген,авамател,лицедил,ново–фамотидин,пепсидин,ульфамид,фамогард,фамонид,фамосан,фамоцид,
этмозин|морацизин гидрохлорид,
хлоргексидин|гибитан,гибитан,
амбрамицин|амбрамицин,польфамицин,
аксерофтол|витамин а,витамин а,
корватон|корватон,молсидомин,
фталилсульфатиазол|фталилсульфатиазол,сульфаталидин,талазол,
одестон|гимекромон,
флекситал|пентоксифиллин,агапурин,пентилин,ралофект,флекситал,кинетал,
галазолин|отривин,ксилометазолин,
орацеф|цепорекс,цепорекс,цефлон,кефлекс,
пропиликс|дионозил,дионозил,
билипак|билипак,цистобил,холевид,
тринитрол|ангинине,тринитрол,перлинганит,
доксорубицин|зидовудин,ретровир,азидотимидин,
норваск|амлодипин,
аксид|низатидин,
беталок|беталок,карвитол,метопролол,спесикор,битартрат метопролола,
анекаин|бупивакаин,
буфенокс|буметамид,буренекс,
изокет|карвазин,динитросорбилонг,изокет,изосорбида динитрат,
цифран|цифлозин,ципрофлоксацин,цифран,ципробай,ципролет,квинтор,
оксистептин|оксистептин,стиптицин,стиптоген,
кетанест|калипсол,кетамин,кеталар,кетаект,калипсол,
аскорбиновая кислота|витамин с,
нитрепин|байпресс,байпресс,
урографин|верографин,верографин,уротраст,урополинум,тразограф,
клион–д|флагил,метронидазол,клион,клион–д,метрогил,эфлоран,
кислота тилудроновая|скелид,
преднизолона–гемисукцинат|ди–адрессон,
антодин|фамотидин,
азатиоприн|имуран,
пефлоксацин|пефлоксацин,перти,пефлацин,
циклодол|циклодол,артан,ромпаркин,тригексифенидил,
морадол|бефорал,бефорал,стадол,
априкал|априкал,допмин,допамекс,допамин,
ауропан|ауранофин,
билоптин|билоптин,иоподат натрия,орографин–натрий,
дилтизем|блопальцин,дилтиазем,дилтизем,алдиазем,ангизем,дилзем,апо–дилтиаз,гербессер,
ионол|ионол,бутилокситолуол,
хлорпропамид|катанил,диабинез,
астмопент|алупент,
лосек|зероцид,лосек,омез,омезол,омзол,омепрол,омизак,ортанол,осид,промезол,
нозинан|тизерцин,метотримепразин,левомепромазин,
рондомицин|рондомицин,
месна|уромитексан,мистаброн,мукофлюид,
стеметил|хлорперазин,хлорперазин,
бисатин|бисатин,пургофен,
нуридал|нуридал,ниазин,
хинаприл|аккупро,хинаприла гидрохлорид,
адриабластин|адриамицин,ирквилан,
амсакрин|амсакрин,
циклонамин|дицин,циклонамин,аглюмин,
клостильбегит|кломифен,клостильбегит,фертомид,кломид,
сальпирин|анальгин,новалдин,метамизол натрия,
цитонал|цитонал,фосфостильбен,хонван,
нафазолин|нафазолин,санорин,
интерферон|зидовудин,ретровир,азидотимидин,
апулеин|будезонид,пульмикорт,турбухалер,
парацетамол|алведон,доламин,панадол,эффералган,
небцин|бруламицин,тобрамицин,брулацин,обрацин,
метимазол|тиамазол,тимидазол,метизол,метирон,тиамазол,
нимотоп|немотан,нимотопс,немотан,
диамбутол|диамбутол,
соматостатин|соматостатин,
мамдрон|трамадол,трамадол,
параплатин|циклоплатин,циклоплатин,
флормидал|флормидал,дормонид,домонид,версед,
оксистептин|стиптицин,оксистептин,стиптоген,
козаар|лозартан калия,
премарин|гормоплекс,премарин,эстрофеминал,
эпразин|диазинамид,диазинамид,пиразинамид,кевезид,
панергал|эргометрин,эрготрата малеат,панергал,эргостабил,
роцефин|цефтриаксон,цефтриаксон,цефтриаксон натрий,
адверзутен|адверзутен,фурарозина гидрохлорид,гиповаз,минипресс,пратсиол,синетенз,
радедорм|эуноктин,неозепам,эуноктин,
теофиллин|дурофиллин,ксантивент,ретафил,теобиолонг,теотард,теоцин,
витамин е|витамин е,эгевит,альмефрол,эвитан,
гексабарбитала натрий|гексобарбитал,эвипан натрий,гексабарбитала натрий,нарконал,
диформин–ретард|метформин,глюкофаг,
геопен|пиопен,геопен,карбенициллин,
пентрит|дилкоран–80,нитропентон,дилкоран–80,
птимал|триметадион,триметадион,
бупивакаин|бупивакаин,
флюоцинолона ацетонид|флокорт,синандон,флокорт,синалар,флюцинар,
ледеркорт|берликорт,кенакорт,триамцинолон,берликорт,
флуразепама гидрохлорид|апо–флуразепам,
тизамид|эпразин,диазинамид,пиразинамид,кевезид,
пиндолол|вискен,пинлок,
пирантель|комбантрин,пирантель памоат,
фурагин|акритоин,
амиодарон|амиодарон,трангорекс,
этамзилат|дицин,циклонамин,аглюмин,
лоратидин|лоратидин,
нифтолид|флуцином,флюцином,цебатрол,дрогенил,эуфлекс,фугерол,фульфорель,гибитрон,нифтолид,норекс,
наркотан|галотан,галотан,
адалат|кардипин,коринфар,адалат,нифедипин,кордафен,кальцигард,нифедикап,
дицин|дицин,циклонамин,аглюмин,
осид|зероцид,лосек,омез,омезол,омзол,омепрол,омизак,ортанол,осид,промезол,
полидан|натрия нуклеоспермат,
транекс|хлоразепам,хлоразепам,
гуамид|гуамид,сульфагуанид,
сомбревин|эпонтол,пропанидид,
фентанил|фентанилцитрат,сентонил,
ранитидин гидрохлорид|ранитидин,ранитидин гидрохлорид,гистак,зоран,ранисан,ранитин,
блокацид|гастроген,антодин,апо–фамотидин,гастроген,авамател,лицедил,ново–фамотидин,пепсидин,ульфамид,фамогард,фамонид,фамосан,фамоцид,
ретровир|интерферон,зидовудин,азидотимидин,
урографин|верографин,урографин,уротраст,урополинум,тразограф,
артан|циклодол,артан,ромпаркин,тригексифенидил,
низатидин|аксид,
гемофер пролонгатум|сульфат железа,гемофер пролонгатум,феоспан,
аценокоумарол|аценокоумарол,тромбостоп,
антипар|антипар,депаркин,
соматотропин человека|тибон растворимый,
лоратадин|флонидан,
альбуцид–натрий|альбуцид–натрий,пронтамид,сульфацетамид,
парлодел|бромокрептин,бромэргон,правидель,
норексадрин|артеренол,артеренол,норэпинефрин,
тетризолин|тетрагидрозолина гидрохлорид,тетрагидрозолина гидрохлорид,
ауранофин|ауранофин,
новотрон|соласпон,соласпон,сульфоназин,
сибазон|седуксен,реланиум,валиум,диазепам,
мукосол|карбоцистеин,карбоцистеин,
фурарозина гидрохлорид|адверзутен,фурарозина гидрохлорид,гиповаз,минипресс,пратсиол,синетенз,
этинилэстрадиол|этинилэстрадиол,фолликорал,
хелатон|хелатон,мосатил,
цитозар|алексан,алексан,
тефамин|диафиллин,аминофиллин,диафиллин,
новодрин|изадрин,алудрин,изупрел,эуспиран,
орацеф|цепорекс,цефлон,орацеф,кефлекс,
глибутид|адебит,силубин,буформин,
триоксазин|седоксазин,триметозин,
фульфорель|флуцином,флюцином,цебатрол,дрогенил,эуфлекс,фугерол,фульфорель,гибитрон,нифтолид,норекс,
перфеназин|хлорпиперазин,хлорпиперазин,фентазин,
алимемазин|алимемазин,алимезин,
декортон|дезоксикортикостерона ацетат,дезоксикортон,докса,перкортен,
тофрин|терфенадин,
кромогликат натрия|налкром,
пурген|пурген,пургил,
имап|флюспирилен,редептин,
изокет|изокет,карвазин,динитросорбилонг,изосорбида динитрат,
фолиевая кислота|фолацин,витамин вс,
дуапен|бензатин–пенициллин,дуапен,бензатина бензилпенициллин,
нозинан|метотримепразин,нозинан,левомепромазин,
прегнин|прегнорал,прогесторал,этистерон,
метизол|тиамазол,метимазол,тимидазол,метирон,тиамазол,
фталилсульфатиазол|талазол,сульфаталидин,талазол,
эфлоран|флагил,метронидазол,клион,клион–д,метрогил,эфлоран,
спиропент|контраспазмин,контраспазмин,
левомицетин|биофеникол,хлорамфеникол,
наликсан|неграм,наликсан,
фолацин|витамин вс,витамин вс,
амброксол|дигноброксол,амбробен,бронхопрон,дигноброксол,мукосолван,
трамал|мамдрон,трамадол,
триметин|птимал,триметадион,
дамилена малеинат|триптизол,амитриптилина малеинат,
гаргилон|декамин,декадин,
l–допа|допафлекс,допафлекс,леводопа,
наркотан|наркотан,галотан,
фосфомицин|фосфомицин,
стугерон|вертизин,вертизин,
кардил|блопальцин,дилтиазем,дилтизем,алдиазем,ангизем,дилзем,апо–дилтиаз,гербессер,
алведон|алведон,доламин,панадол,эффералган,
роксикам|роксикам,пирокс,
тразодон|тразодона гидрохлорид,тразодон,триттико,
трилен|трилен,наркоген,трихлорен,
кеналог– 40|кенакорт,ледеркорт,триамцинолон,берликорт,
терфлюзин|стелазин,терфлюзин,трифлуоперазин,
изоптин|изоптин,веранорм,верапамил,лекоптин,
кореберон|натрия фторид,натрия флюорат,
этамбутол|диамбутол,
силимарин|гепадестал,гепадестал,карзил,лепротек,
котарнина хлорид|стиптицин,оксистептин,стиптоген,
лиродин–депо|лиродин–депо,флуфеназин,
роксикам|роксикам,пирокс,
рибофлавина мононуклеотид|рибофосфин,
опиган|опиган,пимозид,
флюцинар|флокорт,синандон,флокорт,флюоцинолона ацетонид,синалар,
айрол|весаноид,ретин–а,третиноин,
тиомедон|ациметион,ациметион,
элениум|хлозепид,тимазин,либриум,
ципролет|цифлозин,ципрофлоксацин,цифран,ципробай,ципролет,квинтор,
антабус|антабус,
l–допа|l–допа,допафлекс,леводопа,
оксапренолол гидрохлорид|оксапренолол гидрохлорид,слоу–тразиктор,
триседил|трифлуперидол,триперидол,
санедрин|эфедрин,эфедрин,эфетонин,
лексотан|бромидем,калмепам,лексилиум,лексотан,нормок,
раузедил|раузедил,серпазил,
изафенин|бисатин,пургофен,
клофибрат|атромидин,атромидин,
апо–сульфинпиразон|сульфинпиразон,
стелазин|терфлюзин,терфлюзин,трифлуоперазин,
орографин–натрий|иоподат натрия,билоптин,иоподат натрия,
преноксидиазин|преноксидиазин,тибексин,
тринидин|тринидин,тизанидин,
фурадантин|фурадантин,нитрофурантоин,
витамин в6|витамин в6,пиривитол,
мебедазол|вермокс,немазол,антиокс,медозил,
талинолол|талинолол,
флюцином|флуцином,флюцином,цебатрол,дрогенил,эуфлекс,фугерол,фульфорель,гибитрон,нифтолид,норекс,
урополинум|верографин,урографин,уротраст,урополинум,тразограф,
новитропан|оксибутинин,
нео–квипенил|авлон,авлон,
азстреонам|азстреонам,
этилхлорид|этилхлорид,хелен,
гистодил|циметидин,тагамет,нейтронорм,беломет,
неместран|гестринон,
добезилат кальция|добезилат кальция,добесифар,доксилек,
уриспас|флавоксат,
кломифен|фертомид,клостильбегит,фертомид,кломид,
прокаинамид|амидопрокаин,амидопрокаин,кардиоритмин,прокардил,прокаинамида гидрохлорид,
ангиотензинамид|гипертензин,
гексорал|гексетидин,
вепезид|везпид,эпиподофиллотокс,вепзид,везпид,
бензобамил|бензамил,бензоилбарбамил,
нандролон|нандролон,феноболил,туринабол,
нафазолин|санорин,санорин,
андриол|тестостерон андеканоат,
кеторол|нато,кетанов,кеторол,торадол,торолак,
альфаферон|интерферон альфа,
цефапирин натрия|цефапирин натрия,
урополинум|верографин,верографин,урографин,уротраст,тразограф,
ранисан|зантак,ранитидин,ранитидин гидрохлорид,гистак,зоран,ранитин,
гастрил|пирензепин,гастрил,гастрозем,гастрозепин,
дибазол|бендазола гидрохлорид,
омепразол|зероцид,лосек,омез,омезол,омзол,омепрол,омизак,ортанол,осид,промезол,
перкортен–м|дезоксикортикостерона триметилацетат,
пиразинамид|диазинамид,эпразин,диазинамид,кевезид,
клонидин|гемитон,гемитон,катапресан,хлофазолин,
нитропентон|нитропентон,пентрит,дилкоран–80,
спектиномицин|тробицин,
фамоцид|гастроген,антодин,апо–фамотидин,блокацид,гастроген,авамател,лицедил,ново–фамотидин,пепсидин,ульфамид,фамогард,фамонид,фамосан,
тиамазол|метимазол,тимидазол,метизол,метирон,тиамазол,
пипофезин|азафен,
сульфадимезин|сульфадимеразин,
тиофосфамид|тиотэф,теспамим,тиотепа,
ампициллина натриевая соль|пентрексил,пенброк,
брулацин|бруламицин,небцин,тобрамицин,обрацин,
аллилэстренол|гестанин,гестанин,оргагестон,
астемизол|гисманал,
ранисан|ранитидин,ранитидин гидрохлорид,гистак,зоран,ранисан,ранитин,
бекламид|бекламид,
беталок|карвитол,метопролол,беталок,спесикор,битартрат метопролола,
резерпин|раузедил,серпазил,
гликлазид|гликлазид,диамикрон,медоклацид,
лонгацеф|цефтриаксон,цефтриаксон натрий,роцефин,
пинлок|пинлок,пиндолол,
ангиоприл|каптоприл,ангиоприл,катопил,тензиомин,
ангиоприл|ангиоприл,каптоприл,катопил,тензиомин,
аминокаин|аминокаин,прокаина гидрохлорид,цитокаин,панкаин,синтокаин,
вепзид|вепезид,эпиподофиллотокс,вепзид,везпид,
амбробен|дигноброксол,бронхопрон,дигноброксол,мукосолван,амброксол,
пефлоксацин|абактал,перти,пефлацин,
гипертензин|гипертензин,
фарингосепт|амбазон,
гиперицин|деприм,туриневрин,
компламин|теоникол,теоникол,ксавин,
андразид|тубазид,андразид,искотин,
гастрил|гастрил,пирензепин,гастрозем,гастрозепин,
барбинал|дормирал,люминал,дормирал,
дибунол|ионол,бутилокситолуол,
таурин|таурин,
цитокаин|прокаина гидрохлорид,аминокаин,цитокаин,панкаин,синтокаин,
диаметон|диаметон,дуфадин,
динезин|антипар,депаркин,
верошпирон|алдактон,спиронолактон,
адроксон|адреноксил,хромадрен,сангостатин,
токоферола ацетат|витамин е,эгевит,альмефрол,эвитан,
фтивазид|ванизид,
третиноин|весаноид,
тиопентал–натрий|тиопентал натрия,пентотиобарбитал,тионан,
фарлутал|депо–провера,депо–провера,медроксипрогестерон,провера,
тиамина бромид|витамин в1,аневрин,
никардипин|баризин,
дикумарин|пелентан,
молсидомин|сиднофарм,корватон,
адалат|адалат,кардипин,коринфар,нифедипин,кордафен,кальцигард,нифедикап,
фолликорал|этинилэстрадиол,этинилэстрадиол,
ломустин|белустин,
изофрин|изофрин,адрианол,фенилэфрин,
урсодеоксихоловая кислота|урсофальк,
пикнолепсин|азамид,пикнолепсин,этосуксимид,
бензамил|бензамил,бензоилбарбамил,
седуксен|седуксен,реланиум,валиум,диазепам,
пурген|фенолфталеин,пургил,
интенсаин|интенсаин,интенкордин,
ацидамон|аммония хлорид,нашатырь,
метакорталон|дакортин,дакортин,низолон,пренолон,
билизорин|билизорин,изохол,никоформ,
дионин|диолан,диолан,
винбластин*|зидовудин,ретровир,азидотимидин,
оргагестон|гестанин,оргагестон,аллилэстренол,
бензоил пероксид|окси 5,10,
гопатеник–ацид|гопатеник–ацид,
синтомицина эмульсия|синтомицина линимент,
кломифен|кломифен,клостильбегит,фертомид,кломид,
труксал|ветакалм,таразин,ветакалм,
хлорталидон|гигротон,хлорталидон,урандил,
транекс|транекс,хлоразепам,
цистобил|билипак,цистобил,холевид,
исмелин|исмелин,октадин,
пироксикам|роксикам,пирокс,
аскаридил|декарис,кетракс,
сульпирил|догматил,сульпирид,догматил,
бруламицин|небцин,тобрамицин,брулацин,обрацин,
каптоприл|каптоприл,ангиоприл,катопил,тензиомин,
бендазола гидрохлорид|дибазол,
лейковорин|цитворум–фактор,цитворум–фактор,хемифолин,ледерфолин,рескуфолин,тонофолин,
локсуран (б)|дитразина цитрат,баноцид,диэтилкарбамазин,
пимозид|опиган,опиган,
ципрофлоксацин|цифлозин,ципрофлоксацин,цифран,ципробай,ципролет,квинтор,
ионол|ионол,бутилокситолуол,
клион|флагил,метронидазол,клион,клион–д,метрогил,эфлоран,
изупрел|алудрин,изупрел,новодрин,эуспиран,
эбрантил|урапидил,
брулацин|небцин,тобрамицин,брулацин,обрацин,
ангинин|ангинин,соспитан,продектин,
рудотель|рудотель,нобриум,медазепам,
фамонид|гастроген,антодин,апо–фамотидин,блокацид,гастроген,авамател,лицедил,ново–фамотидин,пепсидин,ульфамид,фамогард,фамосан,фамоцид,
арубендол|бриканил,брицин,брикарил,тербуталин,
урапидил|урапидил,
ацеластин|ацеластин,
панкаин|прокаина гидрохлорид,аминокаин,цитокаин,панкаин,синтокаин,
ацетилхолина хлорид|ацеколин,цитохолин,
флюймуцил|ацетеин,флюймуцил,мукомист,мукосольвин,
цефалексин|цепорекс,цефлон,орацеф,кефлекс,
изобромил|бромурал,изобромил,
трихопол|флагил,метронидазол,клион,клион–д,метрогил,эфлоран,
триканикс|фазижин,фазижин,тинигин,тиниба,
эпонтол|эпонтол,пропанидид,
цитворум–фактор|цитворум–фактор,лейковорин,хемифолин,ледерфолин,рескуфолин,тонофолин,
нитразепам|неозепам,эуноктин,радедорм,
авлон|авлон,нео–квипенил,
аргентум протеин|аргентум протеин,
амидопрокаин|амидопрокаин,кардиоритмин,прокардил,прокаинамида гидрохлорид,прокаинамид,
алоперидин|галдол,галдол,сенорм,
вермитин|кофартен,вермитин,
изадрин|алудрин,изупрел,новодрин,эуспиран,
дурофиллин|дурофиллин,ксантивент,ретафил,теобиолонг,теотард,теоцин,
торадол|торадол,нато,кетанов,кеторол,торолак,
альбуцид–натрий|альбуцид–натрий,пронтамид,сульфацетамид,
нобриум|рудотель,нобриум,медазепам,
авлон|авлон,нео–квипенил,
арубендол|арубендол,брицин,брикарил,тербуталин,
цефаклор|цефаклор,альфацет,
фосфостильбен|цитонал,фосфостильбен,хонван,
орунгал|интраконазол,
дицин|дицинон,циклонамин,аглюмин,
осид|зероцид,зероцид,лосек,омез,омезол,омзол,омепрол,омизак,ортанол,промезол,
фторотан|наркотан,галотан,
имифос|маркофан,
сульфазин|адиазин,сульфадиазин,сульфапиримидин,
фениндион|гедулин,гедулин,тромбозол,
клафоран|цефотаксим,
нормикс|нормикс,редактив,
циклонамин|дицинон,дицин,аглюмин,
пуринетол|леукерин,леукерин,
салметерол|салметерол,сальметер,серевент,
тринидин|тринидин,тизанидин,
преноксидиазин|тибексин,тибексин,
роймон|этогель,этофенамат,
цисплатин|платидиам,платинол,платин,
хлорэтил|этилхлорид,хелен,
орап|опиган,пимозид,
мамомит|аминоглютетимид,ориметен,
триканикс|фазижин,триканикс,тинигин,тиниба,
ортанол|зероцид,зероцид,лосек,омез,омезол,омзол,омепрол,омизак,осид,промезол,
риванол|акрицид,акрицид,
пентоксифиллин|пентоксифиллин,агапурин,пентилин,ралофект,флекситал,кинетал,
метофеназин|френолон,
лепсирал|лепсирал,сертан,
надизан|карбутамид,надизан,орабетик,оранил,
карфециллин натриевая соль|утициллин,
адреноксил|адреноксил,хромадрен,сангостатин,
эритростимулин|эритростимулин,
алькопар|алькопар,дебефен,
атенолол|тенолол,тенормин,
ледеркорт|кенакорт,ледеркорт,триамцинолон,берликорт,
мукофлюид|уромитексан,месна,мистаброн,
пикнолепсин|азамид,азамид,этосуксимид,
перкортен|дезоксикортикостерона ацетат,дезоксикортон,докса,декортон,
криптоциллин|оксациллин,оксациллин,резистопен,
холевид|билипак,билипак,цистобил,
фентанилцитрат|фентанил,сентонил,
зантак|ранитидин,ранитидин гидрохлорид,гистак,зоран,ранисан,ранитин,
пургофен|изафенин,бисатин,
ацетеин|ацетеин,флюймуцил,мукомист,мукосольвин,
витамин а|витамин а,аксерофтол,
винкамин|винкамин,
витамин е|витамин е,эгевит,альмефрол,эвитан,
солютизон|тибон растворимый,
мелфалан|алкеран,алкеран,саркоклорин,
неграм|неграм,наликсан,
апетиген|адекин,апетиген,ципродин,ципрогептадина гидрохлорид,
наркоген|трилен,трилен,трихлорен,
этиодан|миодил,этиодан,йофендилатум,
андаксин|андаксин,седанил,мепротан,
сустонит|нитронг,сустак,нитро–мак,
перлинганит|ангинине,ангинине,тринитрол,
тауфон|таурин,
алтезол|спофадазин,кинекс,алтезол,депосульфал,ледеркин,
хуматроп|тибон растворимый,
алимемазин|алимезин,алимезин,
сустак|сустак,нитро–мак,сустонит,
эстрадиола дипропионат|диовициклин,синформон,
допамекс|априкал,допмин,допамекс,допамин,
торемифен|фарестон,
диазоксид|диазоксид,
калипсол|кетамин,кетанест,кеталар,кетаект,калипсол,
нибиол|5–нок,нибиол,ниурон,
триметадион|птимал,триметадион,
фонурит|диакарб,диамокс,ацетазоламид,
дермазин мазь|фламазин,
пирлидол|пиразидол,
эуфлекс|флуцином,флюцином,цебатрол,дрогенил,эуфлекс,фугерол,фульфорель,гибитрон,нифтолид,норекс,
кемовиран|вирузона,вирузона,
седоксазин|седоксазин,триметозин,
платин|цисплатин,платидиам,платинол,
ретаболил|эуболин,туринабол–депо,нандролона деканоат,нероболил,феноболил,
вепезид|вепезид,эпиподофиллотокс,вепзид,везпид,
карбоплатин|циклоплатин,параплатин,
флюспирилен|имап,редептин,
оптикром|хромогликат натрия,
азактам|азстреонам,
хлорпиперазин|хлорпиперазин,перфеназин,фентазин,
тестостерона пропионат|андрофорт,тестолютин,
гликвидон|гликвидон,
пирацетам|ноотропил,
оксипрогестерона капронат|примолют–депо,прогестеро–ретард,
гидроксихлорохин|эреоквин,гидроксихлорохин,
амитетравит|витамин с,
ксавин|теоникол,теоникол,компламин,
эпирубицин|фарморубицин,
вентер|сукральфат,
флекситал|агапурин,пентоксифиллин,агапурин,пентилин,ралофект,кинетал,
ляпис|серебра нитрат,
глюдиазинамид|глибенез,минидиаб,глибенез,глюкотрол,мелизид,менодиаб,миндиаб,минибетик,минодиаб,
адебит|глибутид,силубин,буформин,
омерил|диазолин,мебгидролин,
аминитразол|аминитразол,трихоцид,
флударабина фосфат|флударабина фосфат,флударабин,
дихлотиазид|гидрохлоротиазид,дигидрохлортиазид,дихлотиазид,эзидрекс,нефрикс,
адриамицин|ирквилан,ирквилан,
априкал|допамекс,допмин,допамекс,допамин,
блокацид|антодин,апо–фамотидин,блокацид,гастроген,авамател,лицедил,ново–фамотидин,пепсидин,ульфамид,фамогард,фамонид,фамосан,фамоцид,
сульфапиримидин|адиазин,адиазин,сульфадиазин,
хлорамбуцил|хлорамбуцил,леукеран,
аллопуринол|милурит,апурин,
трирезид|адельфан—эзидрекс,тринитон,
спофадазин|спофадазин,кинекс,алтезол,депосульфал,ледеркин,
биоциллин|бензилпенициллина новокаиновая соль,кристациллин,новоциллин,прокаин–пенициллин,
динитросорбилонг|изокет,карвазин,изокет,изосорбида динитрат,
трамадол|мамдрон,трамадол,
кальция пантотенат|витамин в5,
лексилиум|бромазепам,бромидем,калмепам,лексотан,нормок,
тиотэф|тиотэф,теспамим,тиотепа,
офлоксацин|заноцин,заноцин,
лепонекс|лепонекс,клозапин,
буметамид|буметамид,буренекс,
буметамид|буметамид,буренекс,
леукеран|хлорамбуцил,хлорамбуцил,
перти|пефлоксацин,перти,пефлацин,
глипизид|минидиаб,глибенез,глюкотрол,глюдиазинамид,мелизид,менодиаб,миндиаб,минибетик,минодиаб,
дролептан|инапсин,инапсин,
глюкотрол|глибенез,минидиаб,глибенез,глюдиазинамид,мелизид,менодиаб,миндиаб,минибетик,минодиаб,
гисманал|астемизол,
людиомил|ладиомил,мапротилин,
неостигмина метилсульфат|неостигмина метилсульфат,простигмина метилсульфат,
амсидил|амсакрин,
фосфостильбен|цитонал,цитонал,хонван,
ранитин|зантак,ранитидин,ранитидин гидрохлорид,гистак,зоран,ранисан,
орабет|диабетол,диабетол,толбутамид,
флюспирилен|флюспирилен,редептин,
добезилат кальция|добезилат кальция,добесифар,доксилек,
весаноид|весаноид,ретин–а,третиноин,
диметил–эстроген|диметил–эстроген,
омез|зероцид,лосек,омез,омезол,омзол,омепрол,омизак,ортанол,осид,промезол,
алекситол натрий|актал,
инказан|метралиндол,
квезил|хлорхинальдол,
цефтриаксон|цефтриаксон,цефтриаксон натрий,роцефин,
инапсин|инапсин,дролептан,
флюоцинолона ацетонид|синандон,флокорт,флюоцинолона ацетонид,синалар,флюцинар,
надисал|надисал,
антипирин|анальгезин,феназон,
этаминал–натрий|нембутал натрия,пентобарбитал,натрикум,
напроксен|напроксен,
стенендиол|метандрен,стенендиол,
пепсидин|антодин,апо–фамотидин,блокацид,гастроген,авамател,лицедил,ново–фамотидин,пепсидин,ульфамид,фамогард,фамонид,фамосан,фамоцид,
липантил|фенофибрат,
амиодарон|амиодарон,трангорекс,
гиповаз|гиповаз,адверзутен,фурарозина гидрохлорид,минипресс,пратсиол,синетенз,
спофадазин|депосульфал,кинекс,алтезол,депосульфал,ледеркин,
тиклопидин|тагрен,
бензоилбарбамил|бензамил,бензамил,
ранитидин гидрохлорид|зантак,ранитидин,гистак,зоран,ранисан,ранитин,
антитанил|тахистин,антитанил,ат—10,
тригексифенидил|артан,циклодол,артан,ромпаркин,
иоподат натрия|иоподат натрия,билоптин,орографин–натрий,
суксилеп|азамид,пикнолепсин,этосуксимид,
тимидазол|метимазол,тимидазол,метизол,метирон,тиамазол,
соспитан|ангинин,ангинин,продектин,
оксапренолол гидрохлорид|оксапренолол гидрохлорид,слоу–тразиктор,
веронал–натрий|мединал,веронал–натрий,
хелен|этилхлорид,хелен,
пуритинол|пуритинол,энербол,энцефабол,
бриклин|биклин,амикин,биклин,
торадол|нато,кетанов,кеторол,торадол,торолак,
сульфаметаксозол|бисептол,берлоцид,септрин,сульфаметаксозол,тримоксазол,ко-тримоксазол,
мелизид|глибенез,минидиаб,глибенез,глюкотрол,глюдиазинамид,менодиаб,миндиаб,минибетик,минодиаб,
гилемал|даонил,глибенкламид,даонил,бетанозе,глинил,глиформин,
дитразина цитрат|локсуран (б),баноцид,диэтилкарбамазин,
дрогенил|гибитрон,флуцином,флюцином,цебатрол,эуфлекс,фугерол,фульфорель,гибитрон,нифтолид,норекс,
тетракаина гидрохлорид|дикаин,пантокаин,рексокаин,
рифадин|бенемицин,бенемицин,римактан,
трикорт|полькортолон,кеналог,трикорт,
аквафор|ксипамид,
брицин|арубендол,брицин,брикарил,тербуталин,
кинетал|агапурин,пентоксифиллин,агапурин,пентилин,ралофект,флекситал,
пропаза|аминацил,паск–натрий,аминацил,
гербессер|дилзем,блопальцин,дилтиазем,дилтизем,алдиазем,ангизем,дилзем,апо–дилтиаз,
омезол|зероцид,зероцид,лосек,омез,омзол,омепрол,омизак,ортанол,осид,промезол,
мосатил|хелатон,хелатон,
галдол|галдол,алоперидин,сенорм,
апо–фамотидин|антодин,апо–фамотидин,блокацид,гастроген,авамател,лицедил,ново–фамотидин,пепсидин,ульфамид,фамогард,фамонид,фамосан,фамоцид,
альмефрол|витамин е,витамин е,эгевит,эвитан,
навобан|трописетрон,
полькортолон|трикорт,кеналог,трикорт,
комбантрин|комбантрин,пирантель памоат,
пасомицин|стрептопас,
сульфамонометоксин|диаметон,дуфадин,
даонил|даонил,глибенкламид,бетанозе,гилемал,глинил,глиформин,
фторурацил|флюороурацил,
добутамин|добутрекс,добуэсект,
ципродин|адекин,апетиген,ципродин,ципрогептадина гидрохлорид,
цитохолин|ацеколин,ацеколин,
трирезид–к|тринитон,трирезид,
аминикотин|аминикотин,никофорт,
окселадин цитрат|окселадин цитрат,
тромбонил|дипирдамол,персантин,дипирдамол,
этазол|сульфаэтидол,
дакортин|дакортин,метакорталон,низолон,пренолон,
отривин|галазолин,ксилометазолин,
ранитидин|ацилок–е,гистак,зантак,зоран,ранисан,улькуран,
сандиммун|циклоспорин а,
бенцикламид|галидор,
фугерол|гибитрон,флуцином,флюцином,цебатрол,дрогенил,эуфлекс,фульфорель,гибитрон,нифтолид,норекс,
агапурин|агапурин,пентоксифиллин,пентилин,ралофект,флекситал,кинетал,
эстоцин|локарин,
римактан|бенемицин,бенемицин,рифадин,
апрессин|апресолин,гидралазин,
алдиазем|блопальцин,дилтиазем,дилтизем,алдиазем,ангизем,дилзем,апо–дилтиаз,гербессер,
легалон|гепадестал,силимарин,карзил,лепротек,
тетракаина гидрохлорид|тетракаина гидрохлорид,пантокаин,рексокаин,
хипурик|бензбромарон,дезурик,нормурат,
глинил|даонил,глибенкламид,даонил,бетанозе,гилемал,глиформин,
апо–тиоридазин|тиоридазин,
ацедипрол|депакин,вальпроевая кислота,апилепсин,адедипрол,депакин,депамид,энкорат,
тизанидин|тринидин,тринидин,
хлорохин|делагил,хингамин,резохин,
билоптин|иоподат натрия,иоподат натрия,орографин–натрий,
кефадим|цефтазидим,кефадим,мироцеф,
метандиол|протандрен,протандрен,
индоцид|индоцид,метиндол,
бензалкония хлорид|бензалкония хлорид,
грицин|гризеофульвин,биогризин,
омизак|зероцид,лосек,омез,омезол,омзол,омепрол,омизак,ортанол,осид,промезол,
молграмостим|лейкомакс,
прегнорал|прегнорал,прогесторал,этистерон,
фенопрофен|фенопрофен,
фенилсалицилат|салол,
серпазил|раузедил,раузедил,
лиродин–депо|флуфеназин,флуфеназин,
тобрамицин|бруламицин,небцин,брулацин,обрацин,
напросин|напроксен,
гастродиагност|ацигност,гастродиагност,пептавлон,
букарбан|карбутамид,надизан,орабетик,оранил,
цефподоксим|орелокс,
зоран|ранитидин,ранитидин гидрохлорид,гистак,зоран,ранисан,ранитин,
нилютамид|анандрон,
дигидроэрготоксин|дигидроэрготоксин,секатоксин,эрготоксин д.г,
секатоксин|дигидроэрготоксин,секатоксин,эрготоксин д.г,
финлепсин|тегретол,стазепин,карбамазепин,
метиндол|индометацин,индоцид,
фунгорал|ороназол,кетоконазол,низорал,
диклофенак–натрий|диклофенак,вольтарен,диклофенак,наклофен,
дипирдамол|дипирдамол,персантин,тромбонил,
атропин|атропин,
бусульфан|бусульфан,милеран,
зовиракс|валацикловир,
аминокаин|прокаина гидрохлорид,аминокаин,цитокаин,панкаин,синтокаин,
перфеназин|перфеназин,хлорпиперазин,фентазин,
эргометрина малеат|эргометрин,эрготрата малеат,панергал,эргостабил,
ко-тримоксазол|бактрим (суспензия),бисептол,берлоцид,септрин,сульфаметаксозол,тримоксазол,
эстриол|эстриол,
но–шпа|дротаверин,
этилморфина гидрохлорид|дионин,диолан,
аммония хлорид|нашатырь,ацидамон,
депаркин|антипар,депаркин,
сульпирид|догматил,догматил,сульпирил,
левопа|l–допа,допафлекс,леводопа,
линестренол|оргаметрил,
пентотиобарбитал|тионан,тиопентал натрия,тионан,
гестанин|гестанин,оргагестон,аллилэстренол,
тамоксифен|тамоксифен,нольвадекс,
фозиноприл|фозиноприл,
тамсулозин|тамсулозин,
веронал|веронал,этибарбитал,барбитурал,
кебузоне|кетофенилбутазон,кебузоне,
эстрофеминал|гормоплекс,гормоплекс,премарин,
бутилокситолуол|ионол,ионол,
баноцид|локсуран (б),баноцид,диэтилкарбамазин,
алтезол|депосульфал,спофадазин,кинекс,депосульфал,ледеркин,
искотин|изониазид,тубазид,андразид,
фенасал|кофартен,вермитин,
фунгизон|амфостат,амфостат,
метралиндол|инказан,
аметриодиковая кислота|аметриодиковая кислота,
клопамид|клопамид,
эвитан|витамин е,витамин е,эгевит,альмефрол,
либексин|преноксидиазин,тибексин,
рудотель|рудотель,нобриум,медазепам,
новаин|долотин,долотин,
будезонид|апулеин,пульмикорт,турбухалер,
рифаксимин|нормикс,редактив,
физостигмина салицилат|эзерина салицилат,
ацилок–е|ацилок–е,гистак,зантак,зоран,ранисан,улькуран,
гастроген|гастроген,антодин,апо–фамотидин,блокацид,авамател,лицедил,ново–фамотидин,пепсидин,ульфамид,фамогард,фамонид,фамосан,фамоцид,
норэтистерон|гормолютон,ановул,анзолан,гормолютон,
антиокс|вермокс,мебедазол,немазол,медозил,
верапамил|изоптин,изоптин,веранорм,лекоптин,
депакин|вальпроевая кислота,апилепсин,адедипрол,депакин,ацедипрол,депамид,энкорат,
гастерин|алюминия фосфат,
оранил|букарбан,карбутамид,надизан,орабетик,
тофранил|имипрамин,имизин,депсонил,имипрамин,
троксевазин|венорутон,
салазопирин|салазопирин,салазосульфопиридин,
хлорбутин|хлорамбуцил,леукеран,
демасорб|демасорб,гиадур,
нейтронорм|циметидин,тагамет,нейтронорм,беломет,
дилзем|блопальцин,дилтиазем,дилтизем,алдиазем,ангизем,дилзем,апо–дилтиаз,гербессер,
билимин|билоптин,иоподат натрия,орографин–натрий,
триметозин|седоксазин,седоксазин,
никотиновая кислота|витамин рр,
андразид|изониазид,тубазид,искотин,
анаприлин|индерал,обзидан,пропранолол,
труксал|труксал,таразин,ветакалм,
l–тироксин|l–тироксин,
фенотерол|беротек,партусистен,фенотерол гидробромид,
йодамид|аметриодиковая кислота,
фурадонин|фурадантин,нитрофурантоин,
тегретол|стазепин,финлепсин,карбамазепин,
натрия гидрокарбонат|бикарбонат натрия,
урандил|гигротон,гигротон,хлорталидон,
эффералган|доламин,алведон,доламин,панадол,
маркофан|имифос,
ланитоп|ланитоп,метилдигоксин,медигоксин,
лицедил|антодин,апо–фамотидин,блокацид,гастроген,авамател,лицедил,ново–фамотидин,пепсидин,ульфамид,фамогард,фамонид,фамосан,фамоцид,
мизурана хлорид|амбенона хлорид,амбенона хлорид,
гастрозепин|гастрил,пирензепин,гастрил,гастрозем,
криптонол|криптонол,оксиквинол,
кордафен|адалат,кардипин,коринфар,адалат,нифедипин,кальцигард,нифедикап,
мезокаин|тримекаин,
гастроцепин|пирензепин,гастрил,гастрозем,гастрозепин,
орелокс|цефподоксим,
ферронал|железа глюконат,
гидралазин|апресолин,гидралазин,
дифадал|дифадал,вагоспазмил,
уротраст|верографин,урографин,уротраст,урополинум,тразограф,
реглан|церукал,метоклопрамид,перинорм,
вольтарен|диклофенак,диклофенак–натрий,диклофенак,наклофен,
кефадим|цефтазидим,цефтазидим,мироцеф,
ценариде|билтрицид,празиквантель,
оксациллин|оксациллин,криптоциллин,резистопен,
гексенал|гексобарбитал,эвипан натрий,гексабарбитала натрий,нарконал,
мукосолван|дигноброксол,амбробен,бронхопрон,дигноброксол,амброксол,
цефтриаксон|цефтриаксон,цефтриаксон натрий,роцефин,
ромпаркин|артан,циклодол,артан,тригексифенидил,
анандрон|нилютамид,
бензидамин|бензидамин,
тобрамицин|небцин,тобрамицин,брулацин,обрацин,
цефалин|цефалин,тиопропиразин,
оксодолин|гигротон,хлорталидон,урандил,
биоциллин|биоциллин,кристациллин,новоциллин,прокаин–пенициллин,
седуксен|диазепам,реланиум,валиум,диазепам,
бисептол|бисептол,берлоцид,септрин,сульфаметаксозол,тримоксазол,ко-тримоксазол,
эфетонин|эфедрин,эфедрин,санедрин,
нитрофуран|хемофуран,хемофуран,фурацин,
блеоцин|блеомицин,блеомицин,
кофартен|вермитин,вермитин,
интерферон альфа|интерферон альфа,
хлорпиперазин|перфеназин,хлорпиперазин,фентазин,
клозапин|азалептин,лепонекс,
ангизем|блопальцин,дилтиазем,дилтизем,алдиазем,ангизем,дилзем,апо–дилтиаз,гербессер,
кеналог|полькортолон,кеналог,трикорт,
неоинтестопан|аттапульгит,
перициазин|неулактил,перициазин,
трифтазин|стелазин,терфлюзин,трифлуоперазин,
гидрокортизон|гидрокортизона ацетат,
кромоглициевая кислота|кромоглициевая кислота,
кристациллин|бензилпенициллина новокаиновая соль,биоциллин,новоциллин,прокаин–пенициллин,
витамин в5|витамин в5,
адреноксил|адреноксил,хромадрен,сангостатин,
цифран|ципринол,цифлозин,ципрофлоксацин,ципробай,ципролет,квинтор,
немазол|вермокс,мебедазол,антиокс,медозил,
этогель|этофенамат,роймон,
лазолван|амбробен,бронхопрон,дигноброксол,мукосолван,амброксол,
тразикор|оксапренолол гидрохлорид,слоу–тразиктор,
темазепам|темазепам,
провера|депо–провера,депо–провера,медроксипрогестерон,фарлутал,
капотен|каптоприл,ангиоприл,катопил,тензиомин,
анальгезин|анальгезин,феназон,
толбутамид|диабетол,диабетол,орабет,
гипотиазид|гидрохлоротиазид,дигидрохлортиазид,дихлотиазид,эзидрекс,нефрикс,
ретафил|дурофиллин,дурофиллин,ксантивент,теобиолонг,теотард,теоцин,
прифиния бромид|прифиния бромид,
рифадин|бенемицин,рифадин,римактан,
фалепсин|фалепсин,
трентал|пентоксифиллин,агапурин,пентилин,ралофект,флекситал,кинетал,
теоникол|теоникол,компламин,ксавин,
доксиламин|доксиламин,
лендормин|бротизолам,
ниаламид|нуридал,ниазин,
фетанол|этиладрионол,эффортил,
клемастина фумарат|тавегил,
анальгезин|анальгезин,феназон,
дрогенил|флуцином,флюцином,цебатрол,дрогенил,эуфлекс,фугерол,фульфорель,гибитрон,нифтолид,норекс,
промедол|тримеперидин,
натрия салицилат|надисал,
атромидин|атромидин,клофибрат,
медазепам|рудотель,рудотель,нобриум,
кореберон|кореберон,натрия флюорат,
алдиазем|дилзем,блопальцин,дилтиазем,дилтизем,ангизем,дилзем,апо–дилтиаз,гербессер,
фенотерол гидробромид|партусистен,фенотерол гидробромид,фенотерол,
липомал|липомал,лурселл,
гастрозем|пирензепин,гастрил,гастрозем,гастрозепин,
клобазам|фризиум,
аллерган|пипольфен,аллерган,фенерган,
алоперидин|алоперидин,галдол,сенорм,
бензилпенициллина новокаиновая соль|биоциллин,кристациллин,новоциллин,прокаин–пенициллин,
хемофуран|хемофуран,фурацин,нитрофуран,
неурол|алпразолам,
соталол|дароб,сотагексал,соталекс,
тиопентал натрия|тиопентал натрия,пентотиобарбитал,тионан,
наклофен|диклофенак,вольтарен,диклофенак–натрий,диклофенак,
норексадрин|артеренол,норексадрин,норэпинефрин,
гризеофульвин|биогризин,грицин,
трифлуперидол|триперидол,триперидол,
галотан|наркотан,галотан,
дихлотиазид|дигидрохлортиазид,гидрохлоротиазид,дигидрохлортиазид,эзидрекс,нефрикс,
геопен|геопен,пиопен,карбенициллин,
продектин|ангинин,ангинин,соспитан,
кетаект|кетамин,кетанест,кеталар,кетаект,калипсол,
апетиген|адекин,адекин,ципродин,ципрогептадина гидрохлорид,
спазмолитин|дифадал,вагоспазмил,
флюцином|гибитрон,флуцином,цебатрол,дрогенил,эуфлекс,фугерол,фульфорель,гибитрон,нифтолид,норекс,
цепорекс|цепорекс,цефлон,орацеф,кефлекс,
индоцид|индометацин,метиндол,
ибупрофен|бруфен,ламидон,
турбухалер|будезонид,апулеин,пульмикорт,
мединал|веронал–натрий,веронал–натрий,
даонил|глибенкламид,даонил,бетанозе,гилемал,глинил,глиформин,
пратсиол|адверзутен,фурарозина гидрохлорид,гиповаз,минипресс,пратсиол,синетенз,
хлорперазин|хлорперазин,стеметил,
ангинине|ангинине,тринитрол,перлинганит,
фуросемид|лазикс,фурантрил,
калия гидротартат|трацептин,
тинигин|фазижин,триканикс,тинигин,тиниба,
тиопропиразин|цефалин,цефалин,
тиоктацид|билетан,билетан,
амизил|актозин,бенактизин,луцидил,
аскорутин|витамин с,
ципротерон|ципротерон,ципротерона ацетат,
катапресан|гемитон,гемитон,клонидин,хлофазолин,
адипалит|адипалит,нематоцин,
кетракс|декарис,аскаридил,
сульфапиридазин|спофадазин,кинекс,алтезол,депосульфал,ледеркин,
гистак|ранитидин,ранитидин гидрохлорид,гистак,зоран,ранисан,ранитин,
леривон|миансан,леривон,
докса|дезоксикортикостерона ацетат,дезоксикортон,декортон,перкортен,
декстроза|дектроза,декстроза,
лейкомакс|молграмостим,
улькуран|зантак,ацилок–е,гистак,зантак,зоран,ранисан,
пемпидина тозил|пемпидина тозил,
аденозин фосфат|аденозин фосфат,
диафенилсульфон|авлосульфон,дапсон,
низорал|ороназол,кетоконазол,фунгорал,
тразодона гидрохлорид|тразодона гидрохлорид,тразодон,триттико,
флутамид|флуцином,флюцином,цебатрол,дрогенил,эуфлекс,фугерол,фульфорель,гибитрон,нифтолид,норекс,
ветакалм|труксал,таразин,ветакалм,
кеторолак|нато,кетанов,кеторол,торадол,торолак,
медроксипрогестерон|депо–провера,депо–провера,фарлутал,провера,
неозепам|эуноктин,эуноктин,радедорм,
битартрат метопролола|беталок,карвитол,метопролол,беталок,спесикор,
кардиоритмин|амидопрокаин,кардиоритмин,прокардил,прокаинамида гидрохлорид,прокаинамид,
имипрамин|имизин,тофранил,депсонил,имипрамин,
морацизин гидрохлорид|этмозин,
синандон|флокорт,флокорт,флюоцинолона ацетонид,синалар,флюцинар,
цефтриаксон натрий|цефтриаксон,цефтриаксон,роцефин,
атровент|нормосекретол,норсекрол,ипратропия бромид,
тиоктацид|тиоктацид,билетан,
антипар|депаркин,депаркин,
гаммакортен|гаммакортен,дексазон,
плаквенил|эреоквин,гидроксихлорохин,
хромадрен|адреноксил,хромадрен,сангостатин,
глюренорм|гликвидон,
кетоконазол|ороназол,низорал,фунгорал,
цепорекс|цепорекс,цефлон,орацеф,кефлекс,
нормурат|бензбромарон,бензбромарон,дезурик,
кломид|фертомид,кломифен,клостильбегит,фертомид,
ретин–а|весаноид,весаноид,третиноин,
догматил|сульпирид,догматил,сульпирил,
хенодезоксихолевая кислота|хенодезоксихолевая кислота,хенохол,
амлодипин|амлодипин,
зидовудин|зидовудин,ретровир,азидотимидин,
сетастин|сетастин,
тибон растворимый|тибон растворимый,
лексотан|бромазепам,бромидем,калмепам,лексилиум,нормок,
левомепромазин|тизерцин,метотримепразин,нозинан,
гормоплекс|гормоплекс,премарин,эстрофеминал,
синандон|синандон,флокорт,флюоцинолона ацетонид,синалар,флюцинар,
амбробен|амбробен,бронхопрон,дигноброксол,мукосолван,амброксол,
гексамина|гексамина,урисол,уротропин,
перинорм|церукал,метоклопрамид,реглан,
пефлацин|абактал,пефлоксацин,перти,
амфепрамон|амфепрамон,параболин,
ледерфолин|лейковорин,цитворум–фактор,хемифолин,ледерфолин,рескуфолин,тонофолин,
дебефен|алькопар,дебефен,
амбенона хлорид|амбенона хлорид,мизурана хлорид,
офлоксацин|офлоксацин,заноцин,
лексилиум|бромидем,калмепам,лексилиум,лексотан,нормок,
кетанов|нато,кетанов,кеторол,торадол,торолак,
эстулик|гуанфацин,гуанфацина гидрохлорид,
зофран|ондансетрон,
ипратропия бромид|атровент,нормосекретол,норсекрол,
прогестин|прогестин,прогелан,
фугерол|флуцином,флюцином,цебатрол,дрогенил,эуфлекс,фугерол,фульфорель,гибитрон,нифтолид,норекс,
агапурин|пентоксифиллин,агапурин,пентилин,ралофект,флекситал,кинетал,
омзол|зероцид,лосек,омез,омезол,омзол,омепрол,омизак,ортанол,осид,промезол,
ацилок–е|зантак,гистак,зантак,зоран,ранисан,улькуран,
этофенамат|этогель,роймон,
бенактизин|бенактизин,актозин,луцидил,
нитрофурантоин|фурадантин,фурадантин,
интенкордин|интенсаин,интенкордин,
платифиллина гидротартрат|платифиллин,
седанил|андаксин,седанил,мепротан,
элениум|тимазин,элениум,либриум,
инапсин|инапсин,дролептан,
окси 5|бензоил пероксид,10,
неулактил|перициазин,перициазин,
нитроглицерин|ангинине,тринитрол,перлинганит,
ортанол|зероцид,лосек,омез,омезол,омзол,омепрол,омизак,ортанол,осид,промезол,
иммуноглобулин (человеческий)|иммуноглобулин (человеческий),интраглобин,
налфон|фенопрофен,
карбутамид|букарбан,надизан,орабетик,оранил,
бротизолам|бротизолам,
миансан|леривон,леривон,
нероболил|эуболин,эуболин,туринабол–депо,нандролона деканоат,феноболил,
тербинафин|тербинафин,
валтрекс|валацикловир,
луцидил|бенактизин,актозин,бенактизин,
допамин|допамекс,априкал,допмин,допамекс,
обзидан|индерал,индерал,пропранолол,
мироцеф|цефтазидим,цефтазидим,кефадим,
фертомид|кломифен,клостильбегит,фертомид,кломид,
гексобарбитал|гексабарбитала натрий,эвипан натрий,гексабарбитала натрий,нарконал,
невиграмон|неграм,наликсан,
аккупро|хинаприл,хинаприла гидрохлорид,
ралофект|пентоксифиллин,агапурин,пентилин,ралофект,флекситал,кинетал,
метилдопа|допегит,альдомет,
дикаин|тетракаина гидрохлорид,пантокаин,рексокаин,
катанил|диабинез,диабинез,
мистаброн|уромитексан,месна,мукофлюид,
новострол|дигидростибострол,дигидростибострол,
гибитан|гибитан,хлоргексидин,
примолют–депо|оксипрогестерона капронат,прогестеро–ретард,
инозие f|инозие f,инозин,
адекин|адекин,апетиген,ципродин,ципрогептадина гидрохлорид,
интенсаин|интенкордин,интенкордин,
лепонекс|азалептин,клозапин,
рибофосфин|рибофлавина мононуклеотид,
платинол|цисплатин,платидиам,платин,
декадин|декамин,гаргилон,
сиднофарм|корватон,молсидомин,
лекоптин|изоптин,изоптин,веранорм,верапамил,
демасорб|демасорб,гиадур,
дезоксикортикостерона триметилацетат|перкортен–м,
фенистил|диметинден,
серебрянная соль сульфатиазола|аргосульфан,сульфатиазол,
пинлок|вискен,пиндолол,
альгамон|альгамон,саламид,
фентоламин|дибазин,дибазин,
салициламид|альгамон,саламид,
прокаина гидрохлорид|аминокаин,аминокаин,цитокаин,панкаин,синтокаин,
тенолол|атенолол,тенормин,
нормок|бромазепам,бромидем,калмепам,лексилиум,лексотан,
билтрицид|празиквантель,ценариде,
циннаризин|стугерон,вертизин,
кальцигард|кардипин,коринфар,адалат,нифедипин,кордафен,кальцигард,нифедикап,
сигнопам|темазепам,
криптоциллин|криптоциллин,оксациллин,резистопен,
тринитон|тринитон,трирезид,
артамин|d–пеницилламин,артамин,троловол,
септрин|бисептол,берлоцид,септрин,сульфаметаксозол,тримоксазол,ко-тримоксазол,
веранорм|изоптин,изоптин,верапамил,лекоптин,
карвитол|беталок,метопролол,беталок,спесикор,битартрат метопролола,
диклофенак|диклофенак,вольтарен,диклофенак–натрий,наклофен,
бруфен|ибупрофен,ламидон,
метоптерин|аметоптерин,аметоптерин,
триамцинолон|берликорт,кенакорт,ледеркорт,берликорт,
дипрофиллин|изофилин,
азалептин|лепонекс,клозапин,
вертизин|стугерон,вертизин,
тагрен|тагрен,тиглид,
этиладрионол|этиладрионол,эффортил,
этиладрионол|этиладрионол,эффортил,
билинеурин|билинеурин,луридин,
галлопамил|галлопамил,
левомицетина сукцинат натрия|хлороцид с,
имуран|имуран,
декадин|декадин,гаргилон,
бромидем|бромидем,калмепам,лексилиум,лексотан,нормок,
теноксикам|теноксикам,
азидотимидин|интерферон,зидовудин,ретровир,
флуцином|гибитрон,флюцином,цебатрол,дрогенил,эуфлекс,фугерол,фульфорель,гибитрон,нифтолид,норекс,
серебро коллоидное|серебро коллоидное,
гемзар|гемцитабин,
тензиомин|ангиоприл,каптоприл,ангиоприл,катопил,
5–нок|нибиол,нибиол,ниурон,
нозепам|тазепам,оксазепам,
сукральфат|вентер,
циметидин|флуразепама гидрохлорид,
винкристин|зидовудин,ретровир,азидотимидин,
тимидазол|тиамазол,метимазол,метизол,метирон,тиамазол,
квинтор|ципринол,цифлозин,ципрофлоксацин,цифран,ципробай,ципролет,
атромидин|атромидин,клофибрат,
минтакол|фосфакол,солюглауцит,
урисол|гексамина,урисол,уротропин,
аценокоумарол|аценокоумарол,тромбостоп,
эзидрекс|дигидрохлортиазид,гидрохлоротиазид,дигидрохлортиазид,дихлотиазид,нефрикс,
сарколизин|алкеран,мелфалан,саркоклорин,
урегит|гидромедин,
промезол|зероцид,зероцид,лосек,омез,омезол,омзол,омепрол,омизак,ортанол,осид,
фенитоин|фенитоин,дифентоин,
бисакодил|дульколакс,
хлофазолин|гемитон,гемитон,катапресан,клонидин,
хлорперазин|хлорперазин,стеметил,
берлоцид|бисептол,берлоцид,септрин,сульфаметаксозол,тримоксазол,ко-тримоксазол,
птимал|птимал,триметадион,
кефлекс|цепорекс,цепорекс,цефлон,орацеф,
лепротек|гепадестал,гепадестал,силимарин,карзил,
мапротилин|ладиомил,ладиомил,
допафлекс|допафлекс,l–допа,леводопа,
нитропентон|дилкоран–80,пентрит,дилкоран–80,
реланиум|седуксен,реланиум,валиум,диазепам,
хлодитан|митотан,
флавоксат|уриспас,
феноболил|эуболин,эуболин,туринабол–депо,нандролона деканоат,нероболил,
гексаметилентетрамин|гексамина,урисол,уротропин,
пилокарпина гидрохлорид|пилокарпин,
партусистен|беротек,фенотерол гидробромид,фенотерол,
ферро–градумет|сульфат железа,гемофер пролонгатум,феоспан,
прогестин|прогелан,прогелан,
прокаинамида гидрохлорид|амидопрокаин,амидопрокаин,кардиоритмин,прокардил,прокаинамид,
d–пеницилламин|d–пеницилламин,артамин,троловол,
берликорт|кенакорт,ледеркорт,триамцинолон,берликорт,
бруфен|бруфен,ламидон,
цебатрол|флуцином,флюцином,цебатрол,дрогенил,эуфлекс,фугерол,фульфорель,гибитрон,нифтолид,норекс,
тимазин|хлозепид,элениум,либриум,
диовициклин|диовициклин,синформон,
окси 5|окси 5,10,
альдомет|допегит,метилдопа,
скелид|кислота тилудроновая,
кофартен|кофартен,вермитин,
примостат|депостат,
индерал|индерал,обзидан,пропранолол,
ралофект|агапурин,пентоксифиллин,агапурин,пентилин,флекситал,кинетал,
примолют–депо|примолют–депо,прогестеро–ретард,
пилокарпин|пилокарпин,
миконал|дактарин,дактарин,суролан,
мукомист|ацетеин,ацетеин,флюймуцил,мукосольвин,
димедрол|аллерган б,бенадрил,
метотримепразин|тизерцин,нозинан,левомепромазин,
фенилин|гедулин,тромбозол,фениндион,
неграм|наликсан,наликсан,
диклофенак–натрий|вольтарен,диклофенак–натрий,диклофенак,наклофен,
анексат|флумазенил,
пирантель памоат|пирантель,комбантрин,
магнезия сернокислая|горькая соль,горькая соль,
гливенол|трибенозид,
этимид|глютамисол,глютамисол,
холина хлорид|билинеурин,луридин,
аминацил|паск–натрий,аминацил,пропаза,
фарлутал|депо–провера,медроксипрогестерон,фарлутал,провера,
соматотропин|соматотропин,
лактофлавин|витамин в2,витамин в2,
энкорат|депакин,вальпроевая кислота,апилепсин,адедипрол,депакин,ацедипрол,депамид,
амфепрамон|амфепрамон,параболин,
брицин|бриканил,арубендол,брикарил,тербуталин,
цибазол|цибазол,сульфазол,
туриневрин|деприм,деприм,
апо–дилтиаз|дилзем,блопальцин,дилтиазем,дилтизем,алдиазем,ангизем,дилзем,гербессер,
надизан|букарбан,карбутамид,орабетик,оранил,
цефобид|цефоперазон,
индерал|индерал,обзидан,пропранолол,
авлохин|абитрен,ятрен,абитрен,
ладиомил|ладиомил,мапротилин,
натрия гипосульфит|натрия гипосульфит,
неомицина сульфат|колимицин,неомин,
реланиум|диазепам,седуксен,валиум,диазепам,
аттапульгит|аттапульгит,
эреоквин|гидроксихлорохин,гидроксихлорохин,
цеклор|цефаклор,альфацет,
фортрал|пентазоцин,
кетаект|калипсол,кетамин,кетанест,кеталар,калипсол,
новотрон|новотрон,соласпон,сульфоназин,
адедипрол|депакин,вальпроевая кислота,апилепсин,депакин,ацедипрол,депамид,энкорат,
нефрикс|дигидрохлортиазид,гидрохлоротиазид,дигидрохлортиазид,дихлотиазид,эзидрекс,
норэпинефрин|артеренол,артеренол,норексадрин,
дроперидол|инапсин,дролептан,
энербол|энербол,пуритинол,энцефабол,
примахин|авлон,нео–квипенил,
медезон|урбазон,урбазон,метилпреднизолон,солю–медрол,
эрготрата малеат|эргометрин,эрготрата малеат,панергал,эргостабил,
миодил|йофендилатум,этиодан,йофендилатум,
изофилин|изофилин,
кетофенилбутазон|кетофенилбутазон,кебузоне,
амитриптилин|триптизол,амитриптилина малеинат,
ацетилцистеин|ацетеин,флюймуцил,мукомист,мукосольвин,
пратсиол|гиповаз,адверзутен,фурарозина гидрохлорид,гиповаз,минипресс,синетенз,
циклоспорин а|циклоспорин а,
дианабол|дианабол,неробол,
делагил|хингамин,хлорохин,резохин,
цититон|ттс “циперкутен”,цитизин,
оксиквинол|хинозол,криптонол,
синафлан|синандон,флокорт,флюоцинолона ацетонид,синалар,флюцинар,
йофендилатум|миодил,этиодан,йофендилатум,
антелепсин|клоназепам,
дипотассиум клоразепат|дипотассиум клоразепат,дикалия клоразепат,
аминикотин|аминикотин,никофорт,
бромурал|изобромил,изобромил,
изосорбид мононитрат|изосорбид мононитрат,
наркоген|трилен,наркоген,трихлорен,
пиопен|пиопен,геопен,карбенициллин,
бисатин|изафенин,пургофен,
бромазепам|бромидем,калмепам,лексилиум,лексотан,нормок,
ацетилсалициловая кислота микрокапсулированная|ацетилсалициловая кислота микрокапсулированная,
кломифена цитрат|кломифен,клостильбегит,фертомид,кломид,
омник|тамсулозин,
ацикловир|виролекс,зовиракс,
дипирдамол|персантин,дипирдамол,тромбонил,
нандролона деканоат|эуболин,эуболин,туринабол–депо,нероболил,феноболил,
адедипрол|вальпроевая кислота,апилепсин,адедипрол,депакин,ацедипрол,депамид,энкорат,
прогесторал|этистерон,прегнорал,этистерон,
галоперидол|алоперидин,галдол,сенорм,
норекс|гибитрон,флуцином,флюцином,цебатрол,дрогенил,эуфлекс,фугерол,фульфорель,гибитрон,нифтолид,
допафлекс|l–допа,допафлекс,леводопа,
пиридостигмин|местинон,пиридостигмин,пиридостигмина бромид,
тиопентал натрия|тионан,пентотиобарбитал,тионан,
бекотид|бекломет,альдецин,беклометазон,
брикарил|амикин,биклин,бриклин,
блеоцин|блеоцин,блеомицин,
цитизин|ттс “циперкутен”,цититон,
фенкарол|квифенадин,хифенадин,
калмепам|бромазепам,бромидем,лексилиум,лексотан,нормок,
дифентоин|дифенин,фенитоин,
липостат|правастатин,
калия перманганат|калий марганцовокислый,
нимотопс|нимотоп,нимотопс,немотан,
инозие f|инозин,инозин,
альдецин|альдецин,бекотид,беклометазон,
тибексин|преноксидиазин,тибексин,
амбрамицин|амбрамицин,польфамицин,
диамокс|диакарб,фонурит,ацетазоламид,
флударабин|флудара,флударабина фосфат,
билизорин|изохол,изохол,никоформ,
туринабол|феноболил,нандролон,феноболил,
хлорпромазин|аминазин,мегафен,
дектроза|декстроза,декстроза,
ледеркин|депосульфал,спофадазин,кинекс,алтезол,депосульфал,
бензогексоний|гексаметония бензоат,
хромадрен|адреноксил,адреноксил,сангостатин,
нейтронорм|гистодил,циметидин,тагамет,беломет,
кетамин|калипсол,кетанест,кеталар,кетаект,калипсол,
железа глюконат|железа глюконат,
метамизол натрия|анальгин,новалдин,сальпирин,
эуфлекс|гибитрон,флуцином,флюцином,цебатрол,дрогенил,фугерол,фульфорель,гибитрон,нифтолид,норекс,
хенохол|хенодезоксихолевая кислота,хенодезоксихолевая кислота,
бромидем|бромазепам,калмепам,лексилиум,лексотан,нормок,
баризин|никардипин,
инозин|инозие f,инозин,
кеторол|торадол,нато,кетанов,торадол,торолак,
калимин|местинон,пиридостигмин,пиридостигмина бромид,
реглан|метоклопрамид,реглан,перинорм,
уросульфан|сульфакарбамид,урамид,
нитрендипин|байпресс,нитрепин,
пентрит|нитропентон,пентрит,дилкоран–80,
барбитал|веронал,этибарбитал,барбитурал,
дигидрохлортиазид|дигидрохлортиазид,гидрохлоротиазид,дихлотиазид,эзидрекс,нефрикс,
гепадестал|гепадестал,силимарин,карзил,лепротек,
глинил|глибенкламид,даонил,бетанозе,гилемал,глинил,глиформин,
абактал|пефлоксацин,перти,пефлацин,
дифенин|фенитоин,дифентоин,
ирквилан|адриамицин,ирквилан,
бекотид|альдецин,бекотид,беклометазон,
фазижин|фазижин,триканикс,тинигин,тиниба,
пирензепин|гастрил,гастрил,гастрозем,гастрозепин,
фепранон|амфепрамон,параболин,
дриол|дриол,
альтеплаза|актилизе,
депо–провера|депо–провера,медроксипрогестерон,фарлутал,провера,
бромэргон|бромокрептин,бромэргон,правидель,
нембутал натрия|нембутал натрия,пентобарбитал,натрикум,
стадол|бефорал,бефорал,морадол,
ксантивент|дурофиллин,ксантивент,ретафил,теобиолонг,теотард,теоцин,
допегит|альдомет,метилдопа,
трепирий йодид|гигроний,
омез|зероцид,зероцид,лосек,омезол,омзол,омепрол,омизак,ортанол,осид,промезол,
ретин–а|весаноид,ретин–а,третиноин,
альгамон|альгамон,саламид,
хинаприл|хинаприл,хинаприла гидрохлорид,
неомин|колимицин,неомин,
катапресан|гемитон,катапресан,клонидин,хлофазолин,
пантокаин|тетракаина гидрохлорид,пантокаин,рексокаин,
фертомид|фертомид,кломифен,клостильбегит,кломид,
аллергодил|ацеластин,
глиформин|даонил,глибенкламид,даонил,бетанозе,гилемал,глинил,
пиопен|геопен,геопен,карбенициллин,
сульфаметаксозол|бактрим (суспензия),бисептол,берлоцид,септрин,тримоксазол,ко-тримоксазол,
митоксантрон|новантрон,
эрготрата малеат|эргометрина малеат,эргометрин,панергал,эргостабил,
алведон|доламин,доламин,панадол,эффералган,
актилизе|альтеплаза,
нормосекретол|нормосекретол,норсекрол,ипратропия бромид,
пронтамид|альбуцид–натрий,альбуцид–натрий,сульфацетамид,
ориметен|ориметен,мамомит,
исмелин|изобарин,октадин,
апулеин|апулеин,пульмикорт,турбухалер,
флудара|флударабина фосфат,флударабин,
дезурик|бензбромарон,бензбромарон,нормурат,
пентилин|агапурин,пентоксифиллин,агапурин,ралофект,флекситал,кинетал,
менодиаб|глибенез,минидиаб,глибенез,глюкотрол,глюдиазинамид,мелизид,миндиаб,минибетик,минодиаб,
добуэсект|добутрекс,добутамин,
галлат висмута основного|дерматол,
эфедрин|эфедрин,эфетонин,санедрин,
глюкотрол|минидиаб,глибенез,глюкотрол,глюдиазинамид,мелизид,менодиаб,миндиаб,минибетик,минодиаб,
дараприм|дараприм,тиндурин,
фолацин|фолацин,витамин вс,
прокаинамида гидрохлорид|амидопрокаин,кардиоритмин,прокардил,прокаинамида гидрохлорид,прокаинамид,
бромизовал|бромурал,изобромил,
нитросорбид|карвазин,динитросорбилонг,изокет,изосорбида динитрат,
апо–лоразепам|лоразепам,
буторфанол|бефорал,морадол,стадол,
ципротерон|андрокур,ципротерона ацетат,
тенолол|тенолол,тенормин,
эзерина салицилат|физостигмина салицилат,
эзидрекс|гидрохлоротиазид,дигидрохлортиазид,дихлотиазид,эзидрекс,нефрикс,
галдол|алоперидин,галдол,сенорм,
верографин|верографин,урографин,уротраст,урополинум,тразограф,
диамикрон|диамикрон,гликлазид,медоклацид,
флагил|эфлоран,метронидазол,клион,клион–д,метрогил,эфлоран,
бриканил|арубендол,брицин,брикарил,тербуталин,
пургил|фенолфталеин,пурген,
феноболил|феноболил,нандролон,туринабол,
нато|нато,кетанов,кеторол,торадол,торолак,
листенон|дитилин,мио–релаксин,
фотемустин|фотемустин,
адреналина гидрохлорид|эпинефрин,
фенфлурамин|фенфлурамин,
циклопирокс|батрафен,
просподия хлорид|проспидин,
нафтизин|нафазолин,санорин,
санорин|нафазолин,санорин,
добутрекс|добутамин,добуэсект,
кортизона ацетат|адресон,кортелан,
дароб|дароб,сотагексал,соталекс,
нифулидон|фуразолидон,трихофурин,
дакортин|дакортин,метакорталон,низолон,пренолон,
циклометиазид|циклопентиазид,навидрекс,
фали–лепсин|фалепсин,
нандролона деканоат|эуболин,туринабол–депо,нандролона деканоат,нероболил,феноболил,
алдактон|верошпирон,спиронолактон,
трацептин|калия гидротартат,
клотримазол|канестен,
валиум|седуксен,реланиум,валиум,диазепам,
депакин|депакин,вальпроевая кислота,апилепсин,адедипрол,ацедипрол,депамид,энкорат,
фентазин|хлорпиперазин,перфеназин,хлорпиперазин,
атропина сульфат|атропин,
фамосан|антодин,апо–фамотидин,блокацид,гастроген,авамател,лицедил,ново–фамотидин,пепсидин,ульфамид,фамогард,фамонид,фамосан,фамоцид,
амфотерицин в|амфостат,фунгизон,
коринфар|кардипин,коринфар,адалат,нифедипин,кордафен,кальцигард,нифедикап,
баноцид|дитразина цитрат,локсуран (б),диэтилкарбамазин,
везпид|вепезид,эпиподофиллотокс,вепзид,везпид,
минодиаб|глибенез,минидиаб,глибенез,глюкотрол,глюдиазинамид,мелизид,менодиаб,миндиаб,минибетик,
неодикумарин|пелентан,
дексаметазон|гаммакортен,дексазон,
метандрен|стенендиол,стенендиол,
пиритрамид|дипидолор,
минибетик|глибенез,минидиаб,глибенез,глюкотрол,глюдиазинамид,мелизид,менодиаб,миндиаб,минодиаб,
галидор|бенцикламид,
ципрофлоксацин|ципринол,цифлозин,цифран,ципробай,ципролет,квинтор,
тромбозол|гедулин,тромбозол,фениндион,
нандролон|феноболил,феноболил,туринабол,
редептин|имап,флюспирилен,
оксифедрина гидрохлорид|оксифедрина гидрохлорид,
норсекрол|нормосекретол,норсекрол,ипратропия бромид,
ат—10|дигидротахистерол,тахистин,антитанил,
орабет|диабетол,орабет,толбутамид,
бромгексин|бисольвон,паксиразол,
цефалотин|кефлин,
аргосульфан|сульфатиазол,серебрянная соль сульфатиазола,
фенолфталеин|пурген,пургил,
тофизопам|грандаксин,
адриамицин|адриамицин,ирквилан,
анальгин|новалдин,сальпирин,метамизол натрия,
алюминия фосфат|гастерин,
дароб|дароб,сотагексал,соталекс,
цебатрол|гибитрон,флуцином,флюцином,дрогенил,эуфлекс,фугерол,фульфорель,гибитрон,нифтолид,норекс,
хинозол|криптонол,оксиквинол,
рексокаин|дикаин,тетракаина гидрохлорид,пантокаин,
курантил|персантин,дипирдамол,тромбонил,
серебра нитрат|ляпис,
бикарбонат натрия|бикарбонат натрия,
глюкофаг|диформин–ретард,метформин,
новокаинамид|амидопрокаин,кардиоритмин,прокардил,прокаинамида гидрохлорид,прокаинамид,
тенормин|атенолол,тенолол,
домонид|флормидал,дормонид,домонид,версед,
тиндурин|дараприм,дараприм,
хлоргексидин биглюконат|гибитан,хлоргексидин,
эфедрина гидрохлорид|эфедрин,эфетонин,санедрин,
катопил|каптоприл,ангиоприл,катопил,тензиомин,
бетагистин|бетагистин,
неостигмина метилсульфат|неостигмина метилсульфат,простигмина метилсульфат,
туринабол–депо|эуболин,туринабол–депо,нандролона деканоат,нероболил,феноболил,
ациметион|ациметион,тиомедон,
леукерин|леукерин,пуринетол,
сульфаталидин|талазол,фталилсульфатиазол,талазол,
прокаина гидрохлорид|прокаина гидрохлорид,аминокаин,цитокаин,панкаин,синтокаин,
адрианол|адрианол,изофрин,фенилэфрин,
нифедикап|адалат,кардипин,коринфар,адалат,нифедипин,кордафен,кальцигард,
беклометазон|бекломет,альдецин,бекотид,
триптизол|триптизол,амитриптилина малеинат,
салазосульфопиридин|салазопирин,салазопирин,
спиронолактон|верошпирон,алдактон,
серевент|азрол,салметерол,сальметер,
ацедипрол|вальпроевая кислота,апилепсин,адедипрол,депакин,ацедипрол,депамид,энкорат,
урсофальк|урсодеоксихоловая кислота,
ципрогептадина гидрохлорид|адекин,адекин,апетиген,ципродин,
хлорталидон|гигротон,гигротон,урандил,
эргометрин|эргометрина малеат,эрготрата малеат,панергал,эргостабил,
аллерган б|димедрол,бенадрил,
алдактон|алдактон,спиронолактон,
зероцид|зероцид,лосек,омез,омезол,омзол,омепрол,омизак,ортанол,осид,промезол,
грандаксин|тофизопам,
калия оротат|диорон,оропур,
тиоацетазон|тибон,амитиозон,
паксиразол|бисольвон,бисольвон,
ксанакс|алпразолам,
метронидазол|эфлоран,флагил,клион,клион–д,метрогил,эфлоран,
септрин|бактрим (суспензия),бисептол,берлоцид,сульфаметаксозол,тримоксазол,ко-тримоксазол,
стугерон|стугерон,вертизин,
сальметер|салметерол,сальметер,серевент,
пиридоксина гидрохлорид|витамин в6,пиривитол,
тербуталин|бриканил,арубендол,брицин,брикарил,
стиптицин|стиптицин,оксистептин,стиптоген,
бекломет|альдецин,бекотид,беклометазон,
дигноброксол|дигноброксол,амбробен,бронхопрон,мукосолван,амброксол,
колимицин|колимицин,неомин,
бутилскополамин|бускопан,
сульфат железа|сульфат железа,гемофер пролонгатум,феоспан,
хлорэтиламиноурацил|допан,
циклофосфан|эндоксан,циклофосфамид,
диабетол|диабетол,орабет,толбутамид,
полькортолон|полькортолон,кеналог,трикорт,
минипресс|гиповаз,адверзутен,фурарозина гидрохлорид,гиповаз,пратсиол,синетенз,
зоран|зантак,ранитидин,ранитидин гидрохлорид,гистак,ранисан,ранитин,
локарин|эстоцин,
фонурит|диамокс,фонурит,ацетазоламид,
квифенадин|хифенадин,хифенадин,
персантин|дипирдамол,дипирдамол,тромбонил,
горькая соль|горькая соль,магнезия сернокислая,
бисольвон|бисольвон,паксиразол,
вискен|пинлок,пиндолол,
тинсет|оксатомид,
тетрациклина гидрохлорид|амбрамицин,польфамицин,
буренекс|буметамид,буметамид,
вальпроевая кислота|вальпроевая кислота,апилепсин,адедипрол,депакин,ацедипрол,депамид,энкорат,
аминоглютетимид|ориметен,мамомит,
ксипамид|аквафор,
теспамим|тиотэф,теспамим,тиотепа,
резохин|делагил,хингамин,хлорохин,
ретровир|зидовудин,ретровир,азидотимидин,
кетофенилбутазон|кебузоне,кебузоне,
квиноцид|хиноцид,
дапсон|авлосульфон,дапсон,
клион|эфлоран,флагил,метронидазол,клион–д,метрогил,эфлоран,
коринфар|адалат,кардипин,адалат,нифедипин,кордафен,кальцигард,нифедикап,
финоптин|изоптин,веранорм,верапамил,лекоптин,
налкром|кромогликат натрия,
циклоплатин|циклоплатин,параплатин,
вепзид|везпид,вепезид,эпиподофиллотокс,везпид,
дормонид|флормидал,дормонид,домонид,версед,
пентрексил|пентрексил,пенброк,
долотин|долотин,новаин,
раузедил|раузедил,серпазил,
артеренол|артеренол,норексадрин,норэпинефрин,
сальметер|азрол,салметерол,серевент,
пентаглобин|иммуноглобулин (человеческий),интраглобин,
бициллин–1|бензатин–пенициллин,дуапен,бензатина бензилпенициллин,
финлепсин|стазепин,финлепсин,карбамазепин,
аминитразол|аминитразол,трихоцид,
ципринол|цифлозин,ципрофлоксацин,цифран,ципробай,ципролет,квинтор,
кинекс|спофадазин,кинекс,алтезол,депосульфал,ледеркин,
нафтамон|алькопар,дебефен,
флагил|флагил,метронидазол,клион,клион–д,метрогил,эфлоран,
этиотраст|миодил,этиодан,йофендилатум,
клион–д|эфлоран,флагил,метронидазол,клион,метрогил,эфлоран,
гиперстат|диазоксид,
карбутамид|карбутамид,надизан,орабетик,оранил,
стелазин|стелазин,терфлюзин,трифлуоперазин,
прогесторал|прегнорал,прогесторал,этистерон,
каптоприл|ангиоприл,ангиоприл,катопил,тензиомин,
фурантрил|лазикс,лазикс,
мукосольвин|ацетеин,ацетеин,флюймуцил,мукомист,
диафиллин|диафиллин,аминофиллин,тефамин,
азона|тразодона гидрохлорид,тразодон,триттико,
навидрекс|циклометиазид,циклопентиазид,
бутамид|диабетол,орабет,толбутамид,
амбенона хлорид|амбенона хлорид,мизурана хлорид,
резистопен|оксациллин,криптоциллин,оксациллин,
сиромин|силибинин,
допмин|априкал,допмин,допамекс,допамин,
гибитрон|флуцином,флюцином,цебатрол,дрогенил,эуфлекс,фугерол,фульфорель,гибитрон,нифтолид,норекс,
фенитоин|дифенин,дифентоин,
фурарозина гидрохлорид|гиповаз,адверзутен,гиповаз,минипресс,пратсиол,синетенз,
тиниба|фазижин,фазижин,триканикс,тинигин,
эфетонин|эфедрин,эфетонин,санедрин,
флормидал|версед,дормонид,домонид,версед,
этионизин|иридозин,иридозин,
неробол|дианабол,дианабол,
азафен|пипофезин,
эндоксан|эндоксан,циклофосфамид,
стрептопас|стрептопас,
дектроза|дектроза,декстроза,
хемифолин|цитворум–фактор,лейковорин,цитворум–фактор,ледерфолин,рескуфолин,тонофолин,
апо–клоразепат|дипотассиум клоразепат,дикалия клоразепат,
дигноброксол|амбробен,бронхопрон,дигноброксол,мукосолван,амброксол,
пилокарпин офтан|пилокарпин,
минидиаб|глибенез,глибенез,глюкотрол,глюдиазинамид,мелизид,менодиаб,миндиаб,минибетик,минодиаб,
имизин|имипрамин,тофранил,депсонил,имипрамин,
фталазол|фталилсульфатиазол,сульфаталидин,талазол,
протаргол|аргентум протеин,
ацикловир|ацикловир,зовиракс,
венорутон|венорутон,
циклопентиазид|циклометиазид,навидрекс,
эстрогены конъюгированные|гормоплекс,премарин,эстрофеминал,
дилкоран–80|нитропентон,пентрит,дилкоран–80,
диафиллин|аминофиллин,диафиллин,тефамин,
хенофалк|хенодезоксихолевая кислота,хенохол,
артан|артан,циклодол,ромпаркин,тригексифенидил,
солюсульфон|новотрон,соласпон,сульфоназин,
амикацин|амикин,биклин,бриклин,
калий марганцовокислый|калий марганцовокислый,
тразограф|верографин,верографин,урографин,уротраст,урополинум,
циклоплатин|циклоплатин,параплатин,
гидроксизин|гидроксизин,
ангинине|ангинине,тринитрол,перлинганит,
милурит|аллопуринол,апурин,
лепсирал|гексамидин,сертан,
пантогам|гопатеник–ацид,
саламид|альгамон,альгамон,
прокардил|амидопрокаин,кардиоритмин,прокардил,прокаинамида гидрохлорид,прокаинамид,
декамин|декадин,гаргилон,
талазол|фталилсульфатиазол,сульфаталидин,талазол,
антиокс|мебедазол,немазол,антиокс,медозил,
беротек|партусистен,фенотерол гидробромид,фенотерол,
алимезин|алимемазин,алимезин,
корватон|сиднофарм,молсидомин,
пронтамид|альбуцид–натрий,пронтамид,сульфацетамид,
эуболин|эуболин,туринабол–депо,нандролона деканоат,нероболил,феноболил,
эуспиран|изадрин,алудрин,изупрел,новодрин,
акрицид|акрицид,риванол,
эргометрин|эргометрин,эрготрата малеат,панергал,эргостабил,
ницерголин|сермион,
сотагексал|дароб,сотагексал,соталекс,
сульфазол|цибазол,цибазол,
амитриптилина малеинат|дамилена малеинат,триптизол,
пентамин|азаметония бромид,
кардипин|кардипин,коринфар,адалат,нифедипин,кордафен,кальцигард,нифедикап,
метформин|диформин–ретард,глюкофаг,
сульфоназин|соласпон,новотрон,соласпон,
купренил р|d–пеницилламин,артамин,троловол,
дигидростибострол|дигидростибострол,новострол,
синетенз|гиповаз,адверзутен,фурарозина гидрохлорид,гиповаз,минипресс,пратсиол,
хонван|цитонал,цитонал,фосфостильбен,
цистобил|билипак,билипак,холевид,
дилтиазем|блопальцин,дилтиазем,дилтизем,алдиазем,ангизем,дилзем,апо–дилтиаз,гербессер,
цефаклор|альфацет,альфацет,
димэстрол|диметил–эстроген,
ановул|норэтистерон,ановул,анзолан,гормолютон,
транксен|транекс,хлоразепам,
пропазин|промилен,протактил,
опиган|опиган,пимозид,
пульмикорт|апулеин,пульмикорт,турбухалер,
сальпирин|новалдин,сальпирин,метамизол натрия,
анзолан|норэтистерон,ановул,анзолан,гормолютон,
пиривитол|витамин в6,витамин в6,
новалдин|анальгин,сальпирин,метамизол натрия,
депосульфал|спофадазин,кинекс,алтезол,депосульфал,ледеркин,
витамин в1|витамин в1,аневрин,
эргостабил|эргометрина малеат,эргометрин,эрготрата малеат,панергал,
хлорохин|хингамин,хлорохин,резохин,
тобитил|теноксикам,
метилдигоксин|ланитоп,ланитоп,медигоксин,
гелюсил|симальдрат,
глибенкламид|глибенкламид,даонил,бетанозе,гилемал,глинил,глиформин,
цитарабин|цитозар,алексан,
прокарбазин|натулан,
батилол|батиловый спирт,
перитол|адекин,апетиген,ципродин,ципрогептадина гидрохлорид,
допамекс|допамекс,априкал,допмин,допамин,
ортоклон|окт–3,окт–3,
витамин d2|витамин d2,кальциферол,
тагамет|циметидин,тагамет,нейтронорм,беломет,
ноотропил|пирацетам,
фентанилцитрат|фентанилцитрат,сентонил,
корданум|талинолол,
биофеникол|биофеникол,хлорамфеникол,
этибарбитал|веронал,веронал,барбитурал,
изофрин|адрианол,изофрин,фенилэфрин,
таразин|ветакалм,труксал,ветакалм,
фликсоназе|флутиказон,
флумазенил|анексат,
карбоцистеин|карбоцистеин,мукосол,
либриум|хлозепид,тимазин,элениум,
канестен|канестен,
бефорал|бефорал,морадол,стадол,
дионозил|дионозил,пропиликс,
барбитал–натрий|мединал,веронал–натрий,
цибазол|цибазол,сульфазол,
цитокаин|аминокаин,прокаина гидрохлорид,аминокаин,панкаин,синтокаин,
фуразолидон|нифулидон,трихофурин,
альфа д3–тева|альфакальцидол,
деприм|деприм,туриневрин,
бромэргон|бромокрептин,бромокрептин,правидель,
аминофиллин|диафиллин,диафиллин,тефамин,
